"aa" = (/turf/closed/wall/rust,/area/space)
"ab" = (/turf/closed/wall,/area/TDM/red_base)
"ac" = (/obj/item/banner/TDM/red,/turf/closed/wall,/area/TDM/red_base)
"ad" = (/turf/closed/wall/rust,/area/TDM)
"ae" = (/turf/open/floor/sepia/TDM,/area/TDM)
"af" = (/obj/structure/ore_box/TDM,/turf/open/floor/sepia/TDM,/area/TDM)
"ag" = (/obj/machinery/power/floodlight{desc = "A pole with powerful mounted lights on it. Due to its high power draw, it must be powered by a direct connection to a wire node. Looks very sturdy."; max_integrity = 1200; name = "sturdy floodlight"},/turf/open/floor/sepia/TDM,/area/TDM)
"ah" = (/obj/structure/window/plastitanium/tough/TDM,/obj/structure/grille,/turf/open/floor/sepia/TDM,/area/TDM)
"ai" = (/obj/structure/barricade/sandbags/TDM,/turf/open/floor/sepia/TDM,/area/TDM)
"aj" = (/obj/item/banner/TDM/blue,/turf/closed/wall,/area/TDM/blue_base)
"ak" = (/obj/structure/window/plastitanium/tough/TDM,/obj/structure/grille,/turf/open/floor/sepia/TDM,/area/TDM/red_base)
"al" = (/obj/structure/mineral_door/iron/TDM,/turf/open/floor/sepia/TDM,/area/TDM/red_base)
"am" = (/turf/closed/wall,/area/TDM/blue_base)
"an" = (/obj/structure/mineral_door/iron/TDM,/turf/open/floor/sepia/TDM,/area/TDM/blue_base)
"ao" = (/obj/structure/window/plastitanium/tough/TDM,/obj/structure/grille,/turf/open/floor/sepia/TDM,/area/TDM/blue_base)
"ap" = (/obj/machinery/power/floodlight,/turf/open/indestructible,/area/TDM/red_base)
"aq" = (/turf/open/floor/plasteel/stairs/TDM/sepia/up,/area/TDM)
"ar" = (/turf/open/floor/plasteel/stairs/TDM/sepia/left,/area/TDM)
"as" = (/turf/open/floor/plasteel/stairs/TDM/sepia/right,/area/TDM)
"at" = (/turf/open/indestructible,/area/TDM/red_base)
"au" = (/obj/machinery/power/floodlight,/turf/open/indestructible,/area/TDM/blue_base)
"av" = (/turf/open/indestructible,/area/TDM/blue_base)
"aw" = (/obj/structure/TDM/wallmed,/turf/closed/wall,/area/TDM/red_base)
"ax" = (/obj/structure/TDM/wallmed,/turf/closed/wall,/area/TDM/blue_base)
"ay" = (/obj/structure/displaycase/TDM_item_spawn{start_showpiece_type = /obj/item/gun/ballistic/revolver/TDM},/turf/open/indestructible,/area/TDM/red_base)
"az" = (/obj/structure/displaycase/TDM_item_spawn{start_showpiece_type = /obj/item/kitchen/knife/combat/TDM},/turf/open/indestructible,/area/TDM/red_base)
"aA" = (/obj/structure/displaycase/TDM_item_spawn{start_showpiece_type = /obj/item/kitchen/knife/combat/TDM},/turf/open/indestructible,/area/TDM/blue_base)
"aB" = (/obj/structure/displaycase/TDM_item_spawn{start_showpiece_type = /obj/item/gun/ballistic/revolver/TDM},/turf/open/indestructible,/area/TDM/blue_base)
"aC" = (/obj/structure/displaycase/TDM_item_spawn{start_showpiece_type = /obj/item/gun/ballistic/shotgun/TDM/buckshot},/turf/open/indestructible,/area/TDM/red_base)
"aD" = (/obj/structure/displaycase/TDM_item_spawn{start_showpiece_type = /obj/item/gun/ballistic/automatic/pistol/TDM},/turf/open/indestructible,/area/TDM/red_base)
"aE" = (/obj/structure/displaycase/TDM_item_spawn{start_showpiece_type = /obj/item/gun/ballistic/automatic/pistol/TDM},/turf/open/indestructible,/area/TDM/blue_base)
"aF" = (/obj/structure/displaycase/TDM_item_spawn{start_showpiece_type = /obj/item/gun/ballistic/shotgun/doublebarrel/TDM},/turf/open/indestructible,/area/TDM/blue_base)
"aG" = (/turf/open/chasm,/area/TDM)
"aH" = (/obj/structure/displaycase/TDM_item_spawn{start_showpiece_type = /obj/item/gun/ballistic/automatic/pistol/APS/TDM},/turf/open/indestructible,/area/TDM/red_base)
"aI" = (/obj/structure/displaycase/TDM_item_spawn{start_showpiece_type = /obj/item/gun/ballistic/automatic/pistol/m1911},/turf/open/indestructible,/area/TDM/red_base)
"aJ" = (/obj/structure/displaycase/TDM_item_spawn{start_showpiece_type = /obj/item/gun/ballistic/automatic/pistol/m1911},/turf/open/indestructible,/area/TDM/blue_base)
"aK" = (/obj/structure/lattice/catwalk,/turf/open/chasm,/area/TDM)
"aL" = (/obj/structure/displaycase/TDM_item_spawn{start_showpiece_type = /obj/item/gun/ballistic/automatic/pistol/APS/TDM},/turf/open/indestructible,/area/TDM/blue_base)
"aM" = (/obj/structure/showcase/machinery/cloning_pod,/turf/open/indestructible,/area/TDM/red_base)
"aN" = (/obj/structure/showcase/machinery/cloning_pod,/turf/open/indestructible,/area/TDM/blue_base)
"aO" = (/obj/structure/displaycase/TDM_item_spawn{start_showpiece_type = /obj/item/shield/riot},/turf/open/indestructible,/area/TDM/red_base)
"aP" = (/obj/structure/barricade/wooden,/turf/open/floor/sepia/TDM,/area/TDM)
"aQ" = (/obj/effect/turf_decal/box,/turf/open/floor/sepia/TDM,/area/TDM)
"aR" = (/obj/structure/displaycase/TDM_item_spawn{start_showpiece_type = /obj/item/shield/riot},/turf/open/indestructible,/area/TDM/blue_base)
"aS" = (/obj/structure/displaycase/TDM_item_spawn{start_showpiece_type = /obj/item/gun/ballistic/automatic/surplus/TDM},/turf/open/indestructible,/area/TDM/red_base)
"aT" = (/obj/structure/displaycase/TDM_item_spawn{start_showpiece_type = /obj/item/gun/ballistic/automatic/pistol/deagle},/turf/open/indestructible,/area/TDM/red_base)
"aU" = (/obj/structure/displaycase/TDM_item_spawn{start_showpiece_type = /obj/item/gun/ballistic/automatic/pistol/deagle},/turf/open/indestructible,/area/TDM/blue_base)
"aV" = (/obj/structure/displaycase/TDM_item_spawn{start_showpiece_type = /obj/item/gun/ballistic/automatic/surplus/TDM},/turf/open/indestructible,/area/TDM/blue_base)
"aW" = (/obj/structure/displaycase/TDM_item_spawn{start_showpiece_type = /obj/item/gun/ballistic/rifle/boltaction},/turf/open/indestructible,/area/TDM/red_base)
"aX" = (/obj/structure/displaycase/TDM_item_spawn{start_showpiece_type = /obj/item/gun/ballistic/automatic/sniper_rifle},/turf/open/indestructible,/area/TDM/red_base)
"aY" = (/obj/structure/displaycase/TDM_item_spawn{start_showpiece_type = /obj/item/gun/ballistic/automatic/sniper_rifle},/turf/open/indestructible,/area/TDM/blue_base)
"aZ" = (/obj/structure/displaycase/TDM_item_spawn{start_showpiece_type = /obj/item/gun/ballistic/rifle/boltaction},/turf/open/indestructible,/area/TDM/blue_base)
"ba" = (/obj/structure/displaycase/TDM_item_spawn{start_showpiece_type = /obj/item/gun/ballistic/automatic/pistol/APS/TDM/uzi},/turf/open/indestructible,/area/TDM/red_base)
"bb" = (/obj/effect/turf_decal/delivery,/turf/open/floor/sepia/TDM,/area/TDM)
"bc" = (/obj/structure/displaycase/TDM_item_spawn{start_showpiece_type = /obj/item/gun/ballistic/automatic/c20r/unrestricted},/turf/open/indestructible,/area/TDM/red_base)
"bd" = (/turf/open/floor/sepia/TDM/dark_10,/area/TDM)
"be" = (/obj/machinery/power/floodlight{desc = "A pole with powerful mounted lights on it. Due to its high power draw, it must be powered by a direct connection to a wire node. Looks very sturdy."; max_integrity = 1200; name = "sturdy floodlight"},/turf/open/floor/sepia/TDM/dark_10,/area/TDM)
"bf" = (/obj/structure/displaycase/TDM_item_spawn{start_showpiece_type = /obj/item/gun/ballistic/automatic/c20r/unrestricted},/turf/open/indestructible,/area/TDM/blue_base)
"bg" = (/obj/item/banner/TDM/red,/turf/closed/wall/rust,/area/TDM)
"bh" = (/obj/item/banner/TDM/blue,/turf/closed/wall/rust,/area/TDM)
"bi" = (/turf/template_noop,/area/template_noop)
"bj" = (/obj/structure/displaycase/TDM_item_spawn{start_showpiece_type = /obj/item/gun/ballistic/automatic/pistol/APS/TDM/uzi},/turf/open/indestructible,/area/TDM/blue_base)
"bk" = (/obj/structure/ore_box/TDM{color = "#e6e6e6"},/turf/open/floor/sepia/TDM/dark_10,/area/TDM)
"bl" = (/obj/effect/turf_decal/box,/obj/effect/turf_decal/box/corners,/turf/open/floor/sepia/TDM,/area/TDM)

(1,1,1) = {"
aaaaaaaaaaaaaaaaaaaaaaaaaaaaaaaaaaaaaaaaaaaaaaaaaaaaaaaaaaaaaaaaaaaaaaaaaaaaaaaaaaaaaaaaaaaaaaaaaaaaaaaaaaaaaaaaaaaaaaaaaaaaaaaaaaaaaaaaaaaaaaaaaaaaaaaaaaaaaaaaaaaaaaaaaaaaaaaaaaaaaaaaaaaaaaaaaa
aaadadadadadadadadadadadadadadadadadadadadadadadadadadadadadadadadadadadadadadadadadadadadadadadadadadadadadadadadadadadadadadadadadadadadadadadadadadadadadadadadadadadadadadadadadadadadadadadaa
aaadadadadadadadadadadadadaeaeaeaeaeaeaeaeaeadadadaeaeaeaeaeaeaeafaeaeaeaeadagaeaeaeaeaeaeaeadaeaeaeadaeaeaeaeaeaeaeagadaeaeaeaeafaeaeaeaeaeaeaeadadadaeaeaeaeaeaeaeaeaeadadadadadadadadadadadadaa
aaadadadadadadadadadadadaeaeaeaeaeaeaeaeaeaeadagaeaeaeaeaeaeaeaeaeaeaeaeaeadaeaeaeaeaeaeafaeaeaeaeaeaeaeafaeaeaeaeaeaeadaeaeaeaeaeaeaeaeaeaeaeaeaeagadaeaeaeaeaeaeaeaeaeaeadadadadadadadadadadadaa
aaadadadadadaeaeaeaeaeaeaeaeafaeaeaeaeaeaeaeaeaeaeaeaeafafafaeaeaeaeaeaeaeaeaeaeaiaiaeaeaeaeaeaeaeaeaeaeaeaeaeaiaiaeaeaeaeaeaeaeaeaeaeafafafaeaeaeaeaeaeaeaeaeaeaeaeafaeaeaeaeaeaeaeaeadadadadadaa
aaadadadadaeaeaeaeaeaeaeaeaeafaeaeaeaeaeaeaeaeaeaeaeaeaeafafaeaeaeaeaeadaeaeaeaeaeaiaiaeaeaeaeaeaeaeaeaeaeaeaiaiaeaeaeaeaeadaeaeaeaeaeafafaeaeaeaeaeaeaeaeaeaeaeaeaeafaeaeaeaeaeaeaeaeaeadadadadaa
aaadadadaeaeaeaeadadagaeaeaeaeaeaeaeadaeaeaeaeadaeaeaeaeaeaeaeaeaeaeaeadaeaeaeaeaeaeaiaeaeaeaeaeaeaeaeaeaeaeaiaeaeaeaeaeaeadaeaeaeaeaeaeaeaeaeaeaeadaeaeaeaeadaeaeaeaeaeaeaeagadadaeaeaeaeadadadaa
aaadadaeaeaeaeadadadadaeaeaeaeaeaeadadaeaeaeaeaeaeaeaeaeaeaeaeafafaeaeaeaeaeadaeaeaeaeaeaeaeaeaeafaeaeaeaeaeaeaeaeaeadaeaeaeaeaeafafaeaeaeaeaeaeaeaeaeaeaeaeadadaeaeaeaeaeaeadadadadaeaeaeaeadadaa
aaadadaeaeaeadadadadadadaqaqadadadadadadadadaeaeaeaeadadadadadadadadaqadadadadadadadaeaeafaeadadadadadaeafaeaeaeadadadadadadaqadadadadadadadadaeaeaeaeadadadadadadadadaqaqadadadadadadaeaeaeadadaa
aaadadaqaqadadadadadadaeaeaeaeadaeaeaeaeaeadaeaeaeaeafadaeaeaeaeadaeaeaeaeadadadaeaeaeaeaeaeadaeagaeadaeaeaeaeaeaeaeadaeaeaeaeaeadaeaeaeaeadafaeaeaeaeadaeaeaeaeaeadaeaeaeaeadadadadadadaqaqadadaa
aaadadaeaeaeaeagadadaeaeaeaeaeadaeaeaeaeaeahaeaeaeaeaearaeaeaeaeaeaeaeaeaeaeadaeaeaeaeaeaeaeaeaeaeaeaeaeaeaeaeaeaeaeadaeaeaeaeaeaeaeaeaeaeasaeaeaeaeaeahaeaeaeaeaeadaeaeaeaeaeadadagaeaeaeaeadadaa
aaadaeaeaeaeaeaeaeaeaeaeaeaeaeagaeaeadaeaeadaeaeaeaeaeadaeaeadaeaeaeaiaeaeaeadaeaeaeaeaeaeaeaeaeaeaeaeaeaeaeaeaeaeaeadaeaeaeaiaeaeaeadaeaeadaeaeaeaeaeadaeaeadaeaeagaeaeaeaeaeaeaeaeaeaeaeaeaeadaa
aaadaeaeaeaeaeaeaeaeaeaeafaeaeaeaeaeadaeaeasaeaeafafaeadaeaeaeaeaeaiaiaeaeaeasaeaeaeaeaeadadadaeaeaeadadadaeaeaeaeaearaeaeaeaiaiaeaeaeaeaeadaeafafaeaearaeaeadaeaeaeaeaeafaeaeaeaeaeaeaeaeaeaeadaa
aaababakabalabababacaeaeaeafaeaeaeaeadaeaeadagaeaeaeaeadadaeaeaeaiaiaeaeaeaeasaeaeadaeaeaeaeadaqaqaqadaeaeaeaeadaeaearaeaeaeaeaiaiaeaeaeadadaeaeaeaeagadaeaeadaeaeaeaeafaeaeaeajamamamanamaoamamaa
aaabapatatatatatapababaeaeaeaeaeadadadaeaeadadahahahadadaeaeaeaiaiaeaeaeaeaeasaeadadaeaeaeaeadaeaeaeadaeaeaeaeadadaearaeaeaeaeaeaiaiaeaeaeadadahahahadadaeaeadadadaeaeaeaeaeamamauavavavavavauamaa
aaabatatatatatatatapabaeaeaeaeaeaeaeadaeaeaeaeaeaeaeaeaeaeaeaeaeaeaeaeaeaeaeadadadadadadaqaqadaeaeaeadaqaqadadadadadadaeaeaeaeaeaeaeaeaeaeaeaeaeaeaeaeaeaeaeadaeaeaeaeaeaeaeamauavavavavavavavamaa
aaabatatatatatatatatabaeaeaeaeaeaeaeadaeaeaeaeaeaeaeaeaeadaeaeaeaeaeaeaeaeaeaeaeaeadadaeaeaeaeaeaeaeaeaeaeaeadadaeaeaeaeaeaeaeaeaeaeaeaeadaeaeaeaeaeaeaeaeaeadaeaeaeaeaeaeaeamavavavavavavavavamaa
aaabatatatabawatatatalaeaeadaeaeaeadadadadadadaeaeaeaeaeadadaeaeaeaeafaeaeaeaeaeaeadaeaeaeaeaeaeaeaeaeaeaeaeaeadaeaeaeaeaeaeafaeaeaeaeadadaeaeaeaeaeadadadadadadaeaeaeadaeaeanavavavaxamavavavamaa
aaabayatatazabatatatalaeaeadaeaeaeaeaeaeaeaeaeaeaeaeaeaeaeadadaeaeafaeaeaeaeadaeaeadaeaeaeaeadaeaeaeadaeaeaeaeadaeaeadaeaeaeaeafaeaeadadaeaeaeaeaeaeaeaeaeaeaeaeaeaeaeadaeaeanavavavamaAavavaBamaa
aaacaCatataDacatatatabaeaeaeaeaeaeaeaeaeaeaeaeaeaeaeaeaeaeaeaeaeaeaeaeaeaeagadaeaeaeaeaeaeaeadadadadadaeaeaeaeaeaeaeadaeaeaeaeaeaeaeaeaeaeaeaeaeaeaeaeaeaeaeaeaeaeaeaeaeaeaeamavavavajaEavavaFajaa
aaabaHatataIabatatatabaeaeaeaeaeaeaeaeaeadaeaeadadadadaeaeaeadaGaGaeaeaeaeadadaeaeaeaeaeaeaeaeadadadaeaeaeaeaeaeaeaeadaeaeaeaeaeaGaGadaeaeaeadadadadaeaeadaeaeaeaeaeaeaeaeaeamavavavamaJavavaLamaa
aaabapatataMabatatatakaeaeaeaeaeaeaeaeadadaeaeaeaeaeadadaeaeaGaGaGaGaKaKaeaeaeaeaeadaeaeaeaeaeagadagaeaeaeaeaeadaeaeadaeaeaKaKaGaGaGaGaeaeadadaeaeaeaeaeadadaeaeaeaeaeaeaeaeaoavavavamaNavavauamaa
aaabaOatatatabatatatakaeaeaeaeaeadadadadadaeaeaeaeaeaeadaeaeaGaGaGaGaKaKaGaeaeaeaeadadadaeaeaeaeaeaeaeaeaeadadadaeaeadaeaGaKaKaGaGaGaGaeaeadaeaeaeaeaeaeadadadadadaeaeaeaeaeaoavavavamavavavaRamaa
aaabapatataMabatatatakaeaeaeaeaeagadadadaeaeaeaeaeaeaeaeaeaeaPaGaGaGaKaKaGaeadaeaeaeaeadaeaeaeaeaQaeaeaeaeadaeaeaeaeadaeaGaKaKaGaGaGaPaeaeaeaeaeaeaeaeaeaeadadadagaeaeaeaeaeaoavavavamaNavavauamaa
aaabaSatataTabatatatabaeaeaeaeaeaeaeadaeaeaeaeaeaeaeaeaeaeaeaeaPaGaGaKaKaGaGadaeaeaeaeaeaeaeaQaeaeaeaQaeaeaeaeaeaeaeadaGaGaKaKaGaGaPaeaeaeaeaeaeaeaeaeaeaeaeadaeaeaeaeaeaeaeamavavavamaUavavaVamaa
aaacaWatataXacatatatabaeaeadaeaeaeaeaeaeaeaeaeaeaeafafaeaeaeaeaeaPaGaKaKaGaGaGaeaeaeaeaeaeaeaeaeaQaeaeaeaeaeaeaeaeaeaGaGaGaKaKaGaPaeaeaeaeaeafafaeaeaeaeaeaeaeaeaeaeaeadaeaeamavavavajaYavavaZajaa
aaabbaatatbcabatatatalaeaeadaeaeaeaeaeaeafafaeaeaeafagaeaeaeaeaeaeaeaeaeaeaGadaeaeaeaeaeaeaQaeaQbbaQaeaQaeaeaeaeaeaeadaGaeaeaeaeaeaeaeaeaeaeagafaeaeaeafafaeaeaeaeaeaeadaeaeanavavavambfavavbjamaa
aaabatatatabawatatatalaeaeadaeaeadadaeaeaeafaeaeaeaeaeaeaeaeaeaeaeaeaeaeaeaeadaeaeaeaeadaeaeaeaeaQaeaeaeaeadaeaeaeaeadaeaeaeaeaeaeaeaeaeaeaeaeaeaeaeaeafaeaeaeadadaeaeadaeaeanavavavaxamavavavamaa
aaabatatatatatatatatabaeaeaeaeaeaeadadaeaeaeaeaeaeaeaeaeaeadadaPadaeaeaeaeaeaeaeaeaeaeadaeaeaQaeaeaeblaeaeadaeaeaeaeaeaeaeaeaeaeadaPadadaeaeaeaeaeaeaeaeaeaeadadaeaeaeaeaeaeamavavavavavavavavamaa
aaabatatatatatatatapabaeaeaeafaeaeaeadadaeaeaeaeaeaeaeaeaeaeaeaeadadadaeaeaeaeaeaeaeaeadaeaeaeaeaQaeaeaeaeadaeaeaeaeaeaeaeaeadadadaeaeaeaeaeaeaeaeaeaeaeaeadadaeaeaeafaeaeaeamauavavavavavavavamaa
aaabapatatatatatapabacaeaeaeaeaeaeaeaeaeaeaeadadaeaeaeaeaeaeafaeaeadaeaeaeaeadagaeaeadadadaeaeaeaeaeaeaeadadadaeaeagadaeaeaeaeadaeaeafaeaeaeaeaeaeadadaeaeaeaeaeaeaeaeaeaeaeajamauavavavavavauamaa
aaababakabalababababaeaeaeaeaeaeaeaeaeaeaeaeaeadadaeaeaeaeaeaeafaeadaeaeaeaeadadadaqadadadadadaqaqaqadadadadadaqadadadaeaeaeaeadaeafaeaeaeaeaeaeadadaeaeaeaeaeaeaeaeaeaeaeaeaeamamamamanamaoamamaa
aaadaeaeaeaeaeaeaeadaeaeadadahahahadadaeaeaeaeaeadadaeaeaeaeaeaeaeadaeaeadadadbdbdbdbdbdadbebdbdbdbdbdbeadbdbdbdbdbdadadadaeaeadaeaeaeaeaeaeaeadadaeaeaeaeaeadadahahahadadaeaeadaeaeaeaeaeaeaeadaa
aaadaeaeaeaeaeaeaeadaeaeadbdbdbdbdbdadaeaeaeaeaeaeaeaeaeadaeaeaeaeaeaeaeaeaeadbdbdbdbdbdbdbdbdbdbdbdbdbdbdbdbdbdbdbdadaeaeaeaeaeaeaeaeaeadaeaeaeaeaeaeaeaeaeadbdbdbdbdbdadaeaeadaeaeaeaeaeaeaeadaa
aaadaeaeaeaeafaeaeaeaeaeahbdbdbdbdbdahaeaeaeaeaeaeaeaeaeadaeaeaeaeaeaeaeaeaeadbdbdadadbdbdbdbdbdbdbdbdbdbdbdadadbdbdadaeaeaeaeaeaeaeaeaeadaeaeaeaeaeaeaeaeaeahbdbdbdbdbdahaeaeaeaeaeafaeaeaeaeadaa
aaadaeaeafafadaeaeaeaeaeadbdbdbdbdbeadagaeaeaeaeaeaeaeadadadadadadadadadaqadadbdbdbdadadbdbdbdbdbdbdbdbdbdadadbdbdbdadadaqadadadadadadadadadaeaeaeaeaeaeaeagadbebdbdbdbdadaeaeaeaeaeadafafaeaeadaa
aaadaeaeafadagaeaeadadadadbdbdbdadadadadadadaqaqadadadadbebdbdbdbdbdbdbdbdadbdbdbdbdbdbdbdbdbdbdbdbdbdbdbdbdbdbdbdbdbdadbdbdbdbdbdbdbdbdbeadadadadaqaqadadadadadadbdbdbdadadadadaeaeagadafaeaeadaa
aaadaeaeafafaeaeaeadbkbdbdbdbdbdbdbdbdbdbkbkbdbdbdbdbeadbdbdbdbdbdbdbdbdbdadbdbdadbdbdbdbdbdbdbdbdbdbdbdbdbdbdbdadbdbdadbdbdbdbdbdbdbdbdbdadbebdbdbdbdbkbkbdbdbdbdbdbdbdbdbdbkadaeaeaeafafaeaeadaa
aaadaeaeafafaeaeaeadbdbdbdbdbdbdbdbdbdbdbdbdbdbdbdbdbdadbdbdbkbkbkbdbdadadadbdbdbdbdbdbdbdbdadadadadadbdbdbdbdbdbdbdbdadadadbdbdbkbkbkbdbdadbdbdbdbdbdbdbdbdbdbdbdbdbdbdbdbdbdadaeaeaeafafaeaeadaa
aaadaeaeaebgaeaeaearbdbdbdbdbdbdadbdbdbdbdbdbdbdbdbdbdbdbdbdbdbkbkbdbdbdbdbkbdbdbdbdadadbdbdadbdbdbdadbdbdadadbdbdbdbdbdbdbdbdbdbkbkbdbdbdbdbdbdbdbdbdbdbdbdbdbdadbdbdbdbdbdbdasaeaeaebhaeaeaeadaa
aaadaeaeaeaeaeaeaearbdbdbdbdbdbdadbkbdbdbdbdbdbdbdbdbdbdbdbdbdadbdbdbdbdbdbdbdbdbdadadbdbdbdbdbdbdbdbdbdbdbdadadbdbdbdbdbdbdbdbdbdadbdbdbdbdbdbdbdbdbdbdbdbdbdbkadbdbdbdbdbdbdasaeaeaeaeaeaeaeadaa
aaadadaeaeaeafaeaeadbdbdbdbdbdbeadbkbkbdbdbdbdbdbdbdbdadbdbdbdbdbdbdbdbdbdbdbdbdadadbdbdadbdbdbdbdbdbdbdadbdbdadadbdbdbdbdbdbdbdbdbdbdbdbdadbdbdbdbdbdbdbdbdbkbkadbebdbdbdbdbdadaeaeafaeaeaeadadaa
aaadadadadadadadadadadadadadadadadadadadadadadadadadadadadadadadadadadadbdbdadadadbdbdbdadadbdbdbdbdbdadadbdbdbdadadadbdbdadadadadadadadadadadadadadadadadadadadadadadadadadadadadadadadadadadadaa
aaaaaaaaaaaaaaaaaaaaaaaaaaaaaaaaaaaaaaaaaaaaaaaaaaaaaaaaaaaaaaaaaaaaaaadbdbdbdadbdbdbdbdbdadbdbdbdbdbdadbdbdbdbdbdadbdbdbdadaaaaaaaaaaaaaaaaaaaaaaaaaaaaaaaaaaaaaaaaaaaaaaaaaaaaaaaaaaaaaaaaaaaaaa
bibibibibibibibibibibibibibibibibibibibibibibibibibibibibibibibibibiaaadadbdbdbdbdbdadbdbdbdbdbdbebdbdbdbdbdadbdbdbdbdbdadadaabibibibibibibibibibibibibibibibibibibibibibibibibibibibibibibibibibi
bibibibibibibibibibibibibibibibibibibibibibibibibibibibibibibibibibiaaaaadadadadadadadadadadadadadadadadadadadadadadadadadaaaabibibibibibibibibibibibibibibibibibibibibibibibibibibibibibibibibibi
bibibibibibibibibibibibibibibibibibibibibibibibibibibibibibibibibibibiaaaaaaaaaaaaaaaaaaaaaaaaaaaaaaaaaaaaaaaaaaaaaaaaaaaaaabibibibibibibibibibibibibibibibibibibibibibibibibibibibibibibibibibibi
"}
