"aa" = (/turf/closed/wall/rust,/area/space)
"ab" = (/obj/item/banner/TDM/blue,/turf/closed/wall/rust,/area/TDM/blue_base)
"ac" = (/turf/closed/wall/rust,/area/TDM/blue_base)
"ad" = (/turf/closed/wall/rust,/area/TDM)
"ae" = (/turf/open/floor/sepia,/area/TDM)
"af" = (/obj/structure/ore_box/TDM,/turf/open/floor/sepia,/area/TDM)
"ag" = (/obj/machinery/power/floodlight{desc = "A pole with powerful mounted lights on it. Due to its high power draw, it must be powered by a direct connection to a wire node. Looks very sturdy."; max_integrity = 1200; name = "sturdy floodlight"},/turf/open/floor/sepia,/area/TDM)
"ah" = (/obj/structure/window/plastitanium/tough/TDM,/obj/structure/grille,/turf/open/floor/sepia,/area/TDM)
"ai" = (/obj/structure/barricade/sandbags/TDM,/turf/open/floor/sepia,/area/TDM)
"aj" = (/turf/closed/wall/rust,/area/TDM/red_base)
"ak" = (/obj/structure/window/plastitanium/tough/TDM,/obj/structure/grille,/turf/open/floor/sepia,/area/TDM/red_base)
"al" = (/obj/structure/mineral_door/iron,/turf/open/floor/sepia,/area/TDM/red_base)
"am" = (/obj/item/banner/TDM/red,/turf/closed/wall/rust,/area/TDM/red_base)
"an" = (/obj/machinery/power/floodlight,/turf/open/floor/sepia,/area/TDM/red_base)
"ao" = (/turf/open/floor/sepia,/area/TDM/red_base)
"ap" = (/obj/structure/displaycase/TDM_item_spawn{start_showpiece_type = /obj/item/gun/ballistic/revolver/TDM},/turf/open/floor/sepia,/area/TDM/red_base)
"aq" = (/turf/open/floor/plasteel/stairs/TDM/sepia/up,/area/TDM)
"ar" = (/turf/open/floor/plasteel/stairs/TDM/sepia/left,/area/TDM)
"as" = (/turf/open/floor/plasteel/stairs/TDM/sepia/right,/area/TDM)
"at" = (/obj/structure/mineral_door/iron,/turf/open/floor/sepia,/area/TDM/blue_base)
"au" = (/obj/structure/window/plastitanium/tough/TDM,/obj/structure/grille,/turf/open/floor/sepia,/area/TDM/blue_base)
"av" = (/obj/machinery/power/floodlight,/turf/open/floor/sepia,/area/TDM/blue_base)
"aw" = (/turf/open/floor/sepia,/area/TDM/blue_base)
"ax" = (/obj/structure/displaycase/TDM_item_spawn{start_showpiece_type = /obj/item/kitchen/knife/combat/TDM},/turf/open/floor/sepia,/area/TDM/red_base)
"ay" = (/obj/structure/displaycase/TDM_item_spawn{start_showpiece_type = /obj/item/kitchen/knife/combat/TDM},/turf/open/floor/sepia,/area/TDM/blue_base)
"az" = (/obj/structure/displaycase/TDM_item_spawn{start_showpiece_type = /obj/item/gun/ballistic/revolver/TDM},/turf/open/floor/sepia,/area/TDM/blue_base)
"aA" = (/obj/structure/displaycase/TDM_item_spawn{start_showpiece_type = /obj/item/gun/ballistic/shotgun/doublebarrel/TDM},/turf/open/floor/sepia,/area/TDM/red_base)
"aB" = (/obj/structure/displaycase/TDM_item_spawn{start_showpiece_type = /obj/item/gun/ballistic/automatic/pistol/TDM},/turf/open/floor/sepia,/area/TDM/red_base)
"aC" = (/obj/structure/displaycase/TDM_item_spawn{start_showpiece_type = /obj/item/gun/ballistic/automatic/pistol/TDM},/turf/open/floor/sepia,/area/TDM/blue_base)
"aD" = (/obj/structure/displaycase/TDM_item_spawn{start_showpiece_type = /obj/item/gun/ballistic/shotgun/doublebarrel/TDM},/turf/open/floor/sepia,/area/TDM/blue_base)
"aE" = (/obj/structure/displaycase/TDM_item_spawn{start_showpiece_type = /obj/item/gun/ballistic/automatic/pistol/APS/TDM},/turf/open/floor/sepia,/area/TDM/red_base)
"aF" = (/obj/structure/displaycase/TDM_item_spawn{start_showpiece_type = /obj/item/gun/ballistic/automatic/pistol/m1911},/turf/open/floor/sepia,/area/TDM/red_base)
"aG" = (/turf/open/chasm,/area/TDM)
"aH" = (/obj/structure/displaycase/TDM_item_spawn{start_showpiece_type = /obj/item/gun/ballistic/automatic/pistol/m1911},/turf/open/floor/sepia,/area/TDM/blue_base)
"aI" = (/obj/structure/displaycase/TDM_item_spawn{start_showpiece_type = /obj/item/gun/ballistic/automatic/pistol/APS/TDM},/turf/open/floor/sepia,/area/TDM/blue_base)
"aJ" = (/obj/structure/showcase/machinery/cloning_pod,/turf/open/floor/sepia,/area/TDM/red_base)
"aK" = (/obj/structure/lattice/catwalk,/turf/open/chasm,/area/TDM)
"aL" = (/obj/structure/showcase/machinery/cloning_pod,/turf/open/floor/sepia,/area/TDM/blue_base)
"aM" = (/obj/structure/displaycase/TDM_item_spawn{start_showpiece_type = /obj/item/shield/riot},/turf/open/floor/sepia,/area/TDM/red_base)
"aN" = (/obj/structure/displaycase/TDM_item_spawn{start_showpiece_type = /obj/item/shield/riot},/turf/open/floor/sepia,/area/TDM/blue_base)
"aO" = (/obj/structure/barricade/wooden,/turf/open/floor/sepia,/area/TDM)
"aP" = (/obj/effect/turf_decal/box,/turf/open/floor/sepia,/area/TDM)
"aQ" = (/obj/structure/displaycase/TDM_item_spawn{start_showpiece_type = /obj/item/gun/ballistic/automatic/surplus/TDM},/turf/open/floor/sepia,/area/TDM/red_base)
"aR" = (/obj/structure/displaycase/TDM_item_spawn{start_showpiece_type = /obj/item/gun/ballistic/automatic/pistol/deagle},/turf/open/floor/sepia,/area/TDM/red_base)
"aS" = (/obj/structure/displaycase/TDM_item_spawn{start_showpiece_type = /obj/item/gun/ballistic/automatic/pistol/deagle},/turf/open/floor/sepia,/area/TDM/blue_base)
"aT" = (/obj/structure/displaycase/TDM_item_spawn{start_showpiece_type = /obj/item/gun/ballistic/automatic/surplus/TDM},/turf/open/floor/sepia,/area/TDM/blue_base)
"aU" = (/obj/structure/displaycase/TDM_item_spawn{start_showpiece_type = /obj/item/gun/ballistic/rifle/boltaction},/turf/open/floor/sepia,/area/TDM/red_base)
"aV" = (/obj/structure/displaycase/TDM_item_spawn{start_showpiece_type = /obj/item/gun/ballistic/automatic/sniper_rifle},/turf/open/floor/sepia,/area/TDM/red_base)
"aW" = (/obj/structure/displaycase/TDM_item_spawn{start_showpiece_type = /obj/item/gun/ballistic/automatic/sniper_rifle},/turf/open/floor/sepia,/area/TDM/blue_base)
"aX" = (/obj/structure/displaycase/TDM_item_spawn{start_showpiece_type = /obj/item/gun/ballistic/rifle/boltaction},/turf/open/floor/sepia,/area/TDM/blue_base)
"aY" = (/obj/structure/displaycase/TDM_item_spawn{start_showpiece_type = /obj/item/gun/ballistic/automatic/pistol/APS/TDM/uzi},/turf/open/floor/sepia,/area/TDM/red_base)
"aZ" = (/obj/structure/displaycase/TDM_item_spawn{start_showpiece_type = /obj/item/gun/ballistic/automatic/c20r/unrestricted},/turf/open/floor/sepia,/area/TDM/red_base)
"ba" = (/obj/effect/turf_decal/delivery,/turf/open/floor/sepia,/area/TDM)
"bb" = (/obj/structure/displaycase/TDM_item_spawn{start_showpiece_type = /obj/item/gun/ballistic/automatic/c20r/unrestricted},/turf/open/floor/sepia,/area/TDM/blue_base)
"bc" = (/obj/effect/turf_decal/box,/obj/effect/turf_decal/box/corners,/turf/open/floor/sepia,/area/TDM)
"bd" = (/turf/open/floor/sepia/TDM/dark_10,/area/TDM)
"be" = (/obj/machinery/power/floodlight{desc = "A pole with powerful mounted lights on it. Due to its high power draw, it must be powered by a direct connection to a wire node. Looks very sturdy."; max_integrity = 1200; name = "sturdy floodlight"},/turf/open/floor/sepia/TDM/dark_10,/area/TDM)
"bf" = (/obj/structure/ore_box/TDM,/turf/open/floor/sepia/TDM/dark_10,/area/TDM)
"bg" = (/obj/item/banner/TDM/red,/turf/closed/wall/rust,/area/TDM)
"bh" = (/obj/item/banner/TDM/blue,/turf/closed/wall/rust,/area/TDM)
"bi" = (/turf/template_noop,/area/template_noop)
"bj" = (/obj/structure/displaycase/TDM_item_spawn{start_showpiece_type = /obj/item/gun/ballistic/automatic/pistol/APS/TDM/uzi},/turf/open/floor/sepia,/area/TDM/blue_base)
"bk" = (/obj/structure/TDM/wallmed,/turf/closed/wall/rust,/area/TDM/red_base)

(1,1,1) = {"
aaaaaaaaaaaaaaaaaaaaaaaaaaaaaaaaaaaaaaaaaaaaaaaaaaaaaaaaaaaaaaaaaaaaaaaaaaaaaaaaaaaaaaaaaaaaaaaaaaaaaaaaaaaaaaaaaaaaaaaaaaaaaaaaaaaaaaaaaaaaaaaaaaaaaaaaaaaaaaaaaaaaaaaaaaaaaaaaaaaaaaaaaaaaaaaaaa
aaadadadadadadadadadadadadadadadadadadadadadadadadadadadadadadadadadadadadadadadadadadadadadadadadadadadadadadadadadadadadadadadadadadadadadadadadadadadadadadadadadadadadadadadadadadadadadadadaa
aaadadadadadadadadadadadadaeaeaeaeaeaeaeaeaeadadadaeaeaeaeaeaeaeafaeaeaeaeadagaeaeaeaeaeaeaeadaeaeaeadaeaeaeaeaeaeaeagadaeaeaeaeafaeaeaeaeaeaeaeadadadaeaeaeaeaeaeaeaeaeadadadadadadadadadadadadaa
aaadadadadadadadadadadadaeaeaeaeaeaeaeaeaeaeadagaeaeaeaeaeaeaeaeaeaeaeaeaeadaeaeaeaeaeaeaeaeaeaeaeaeaeaeaeaeaeaeaeaeaeadaeaeaeaeaeaeaeaeaeaeaeaeaeagadaeaeaeaeaeaeaeaeaeaeadadadadadadadadadadadaa
aaadadadadadaeaeaeaeaeaeaeaeafaeaeaeaeaeaeaeaeaeaeaeaeafafafaeaeaeaeaeaeaeaeaeaeadadaeaeafaeaeaeaeaeaeaeafaeaeadadaeaeaeaeaeaeaeaeaeaeafafafaeaeaeaeaeaeaeaeaeaeaeaeafaeaeaeaeaeaeaeaeadadadadadaa
aaadadadadaeaeaeaeaeaeaeaeaeafaeaeaeaeaeaeaeaeaeaeaeaeaeafafaeaeaeaeaeadaeaeaeaeaeadadaeaeaeaeaeaeaeaeaeaeaeadadaeaeaeaeaeadaeaeaeaeaeafafaeaeaeaeaeaeaeaeaeaeaeaeaeafaeaeaeaeaeaeaeaeaeadadadadaa
aaadadadaeaeaeaeadadagaeaeaeaeaeaeaeadaeaeaeaeadaeaeaeaeaeaeaeaeaeaeaeadaeaeaeaeaeaeadaeaeaeaeaeaeaeaeaeaeaeadaeaeaeaeaeaeadaeaeaeaeaeaeaeaeaeaeaeadaeaeaeaeadaeaeaeaeaeaeaeagadadaeaeaeaeadadadaa
aaadadaeaeaeaeadadadadaeaeaeaeaeaeadadaeaeaeaeaeaeaeaeaeaeaeaeafafaeaeaeaeaeadaeaeaeaeaeaeaeaeaeadaeaeaeaeaeaeaeaeaeadaeaeaeaeaeafafaeaeaeaeaeaeaeaeaeaeaeaeadadaeaeaeaeaeaeadadadadaeaeaeaeadadaa
aaadadaeaeaeadadadadadadaqaqadadadadadadadadaeaeaeaeadadadadadadadadaqadadadadadadadaeaeafaeadadadadadaeafaeaeaeadadadadadadaqadadadadadadadadaeaeaeaeadadadadadadadadaqaqadadadadadadaeaeaeadadaa
aaadadaqaqadadadadadadaeaeaeaeadaeaeaeaeaeadaeaeaeaeafadaeaeaeaeadaeaeaeaeadadadaeaeaeaeaeaeadaeagaeadaeaeaeaeaeaeaeadaeaeaeaeaeadaeaeaeaeadafaeaeaeaeadaeaeaeaeaeadaeaeaeaeadadadadadadaqaqadadaa
aaadadaeaeaeaeagadadaeaeaeaeaeadaeaeaeaeaeahaeaeaeaeaearaeaeaeaeaeaeaeaeaeaeadaeaeaeaeaeaeaeaeaeaeaeaeaeaeaeaeaeaeaeadaeaeaeaeaeaeaeaeaeaeasaeaeaeaeaeahaeaeaeaeaeadaeaeaeaeaeadadagaeaeaeaeadadaa
aaadaeaeaeaeaeaeaeaeaeaeaeaeaeagaeaeadaeaeadaeaeaeaeaeadaeaeadaeaeaeaiaeaeaeadaeaeaeaeaeaeaeaeaeaeaeaeaeaeaeaeaeaeaeadaeaeaeaiaeaeaeadaeaeadaeaeaeaeaeadaeaeadaeaeagaeaeaeaeaeaeaeaeaeaeaeaeaeadaa
aaadaeaeaeaeaeaeaeaeaeaeafaeaeaeaeaeadaeaeasaeaeafafaeadaeaeaeaeaeaiaiaeaeaeasaeaeaeaeaeadadadaeaeaeadadadaeaeaeaeaearaeaeaeaiaiaeaeaeaeaeadaeafafaeaearaeaeadaeaeaeaeaeafaeaeaeaeaeaeaeaeaeaeadaa
aaajajakajalajajajamaeaeaeafaeaeaeaeadaeaeadagaeaeaeaeadadaeaeaeaiaiaeaeaeaeasaeaeadaeaeaeaeadaqaqaqadaeaeaeaeadaeaearaeaeaeaeaiaiaeaeaeadadaeaeaeaeagadaeaeadaeaeaeaeafaeaeaeabacacacatacauacacaa
aaajanaoaoaoaoaoanajajaeaeaeaeaeadadadaeaeadadahahahadadaeaeaeaiaiaeaeaeaeaeasaeadadaeaeaeaeadaeaeaeadaeaeaeaeadadaearaeaeaeaeaeaiaiaeaeaeadadahahahadadaeaeadadadaeaeaeaeaeacacavawawawawawavacaa
aaajaoaoaoaoaoaoaoanajaeaeaeaeaeaeaeadaeaeaeaeaeaeaeaeaeaeaeaeaeaeaeaeaeaeaeadadadadadadaqaqadaeaeaeadaqaqadadadadadadaeaeaeaeaeaeaeaeaeaeaeaeaeaeaeaeaeaeaeadaeaeaeaeaeaeaeacavawawawawawawawacaa
aaajaoaoaoaoaoaoaoaoajaeaeaeaeaeaeaeadaeaeaeaeaeaeaeaeaeadaeaeaeaeaeaeaeaeaeaeaeaeadadaeaeaeaeaeaeaeaeaeaeaeadadaeaeaeaeaeaeaeaeaeaeaeaeadaeaeaeaeaeaeaeaeaeadaeaeaeaeaeaeaeacawawawawawawawawacaa
aaajaoaoaoajbkaoaoaoalaeaeadaeaeaeadadadadadadaeaeaeaeaeadadaeaeaeaeafaeaeaeaeaeaeadaeaeaeaeaeaeaeaeaeaeaeaeaeadaeaeaeaeaeaeafaeaeaeaeadadaeaeaeaeaeadadadadadadaeaeaeadaeaeatawawawacacawawawacaa
aaajapaoaoaxajaoaoaoalaeaeadaeaeaeaeaeaeaeaeaeaeaeaeaeaeaeadadaeaeafaeaeaeaeadaeaeadaeaeaeaeadaeaeaeadaeaeaeaeadaeaeadaeaeaeaeafaeaeadadaeaeaeaeaeaeaeaeaeaeaeaeaeaeaeadaeaeatawawawacayawawazacaa
aaamaAaoaoaBamaoaoaoajaeaeaeaeaeaeaeaeaeaeaeaeaeaeaeaeaeaeaeaeaeaeaeaeaeaeagadaeaeaeaeaeaeaeadadadadadaeaeaeaeaeaeaeadaeaeaeaeaeaeaeaeaeaeaeaeaeaeaeaeaeaeaeaeaeaeaeaeaeaeaeacawawawabaCawawaDabaa
aaajaEaoaoaFajaoaoaoajaeaeaeaeaeaeaeaeaeadaeaeadadadadaeaeaeadaGaGaeaeaeaeadadaeaeaeaeaeaeaeaeadadadaeaeaeaeaeaeaeaeadaeaeaeaeaeaGaGadaeaeaeadadadadaeaeadaeaeaeaeaeaeaeaeaeacawawawacaHawawaIacaa
aaajanaoaoaJajaoaoaoakaeaeaeaeaeaeaeaeadadaeaeaeaeaeadadaeaeaGaGaGaGaKaKaeaeaeaeaeadaeaeaeaeaeagadagaeaeaeaeaeadaeaeadaeaeaKaKaGaGaGaGaeaeadadaeaeaeaeaeadadaeaeaeaeaeaeaeaeauawawawacaLawawavacaa
aaajaMaoaoaoajaoaoaoakaeaeaeaeaeadadadadadaeaeaeaeaeaeadaeaeaGaGaGaGaKaKaGaeaeaeaeadadadaeaeaeaeaeaeaeaeaeadadadaeaeadaeaGaKaKaGaGaGaGaeaeadaeaeaeaeaeaeadadadadadaeaeaeaeaeauawawawacawawawaNacaa
aaajanaoaoaJajaoaoaoakaeaeaeaeaeagadadadaeaeaeaeaeaeaeaeaeaeaOaGaGaGaKaKaGaeadaeaeaeaeadaeaeaeaeaPaeaeaeaeadaeaeaeaeadaeaGaKaKaGaGaGaOaeaeaeaeaeaeaeaeaeaeadadadagaeaeaeaeaeauawawawacaLawawavacaa
aaajaQaoaoaRajaoaoaoajaeaeaeaeaeaeaeadaeaeaeaeaeaeaeaeaeaeaeaeaOaGaGaKaKaGaGadaeaeaeaeaeaeaeaPaeaeaeaPaeaeaeaeaeaeaeadaGaGaKaKaGaGaOaeaeaeaeaeaeaeaeaeaeaeaeadaeaeaeaeaeaeaeacawawawacaSawawaTacaa
aaamaUaoaoaVamaoaoaoajaeaeadaeaeaeaeaeaeaeaeaeaeaeafafaeaeaeaeaeaOaGaKaKaGaGaGaeaeaeaeaeaeaeaeaeaPaeaeaeaeaeaeaeaeaeaGaGaGaKaKaGaOaeaeaeaeaeafafaeaeaeaeaeaeaeaeaeaeaeadaeaeacawawawabaWawawaXabaa
aaajaYaoaoaZajaoaoaoalaeaeadaeaeaeaeaeaeafafaeaeaeafagaeaeaeaeaeaeaeaeaeaeaGadaeaeaeaeaeaeaPaeaPbaaPaeaPaeaeaeaeaeaeadaGaeaeaeaeaeaeaeaeaeaeagafaeaeaeafafaeaeaeaeaeaeadaeaeatawawawacbbawawbjacaa
aaajaoaoaoajbkaoaoaoalaeaeadaeaeadadaeaeaeafaeaeaeaeaeaeaeaeaeaeaeaeaeaeaeaeadaeaeaeaeadaeaeaeaeaPaeaeaeaeadaeaeaeaeadaeaeaeaeaeaeaeaeaeaeaeaeaeaeaeaeafaeaeaeadadaeaeadaeaeatawawawacacawawawacaa
aaajaoaoaoaoaoaoaoaoajaeaeaeaeaeaeadadaeaeaeaeaeaeaeaeaeaeadadaOadaeaeaeaeaeaeaeaeaeaeadaeaeaPaeaeaebcaeaeadaeaeaeaeaeaeaeaeaeaeadaOadadaeaeaeaeaeaeaeaeaeaeadadaeaeaeaeaeaeacawawawawawawawawacaa
aaajaoaoaoaoaoaoaoanajaeaeaeafaeaeaeadadaeaeaeaeaeaeaeaeaeaeaeaeadadadaeaeaeaeaeaeaeaeadaeaeaeaeaPaeaeaeaeadaeaeaeaeaeaeaeaeadadadaeaeaeaeaeaeaeaeaeaeaeaeadadaeaeaeafaeaeaeacavawawawawawawawacaa
aaajanaoaoaoaoaoanajamaeaeaeaeaeaeaeaeaeaeaeadadaeaeaeaeaeaeafaeaeadaeaeaeaeadagaeaeadadadaeaeaeaeaeaeaeadadadaeaeagadaeaeaeaeadaeaeafaeaeaeaeaeaeadadaeaeaeaeaeaeaeaeaeaeaeabacavawawawawawavacaa
aaajajakajalajajajajaeaeaeaeaeaeaeaeaeaeaeaeaeadadaeaeaeaeaeaeafaeadaeaeaeaeadadadaqadadadadadaqaqaqadadadadadaqadadadaeaeaeaeadaeafaeaeaeaeaeaeadadaeaeaeaeaeaeaeaeaeaeaeaeaeacacacacatacauacacaa
aaadaeaeaeaeaeaeaeadaeaeadadahahahadadaeaeaeaeaeadadaeaeaeaeaeaeaeadaeaeadadadbdbdbdbdbdadbebdbdbdbdbdbeadbdbdbdbdbdadadadaeaeadaeaeaeaeaeaeaeadadaeaeaeaeaeadadahahahadadaeaeadaeaeaeaeaeaeaeadaa
aaadaeaeaeaeaeaeaeadaeaeadbdbdbdbdbdadaeaeaeaeaeaeaeaeaeadaeaeaeaeaeaeaeaeaeadbdbdbdbdbdbdbdbdbdbdbdbdbdbdbdbdbdbdbdadaeaeaeaeaeaeaeaeaeadaeaeaeaeaeaeaeaeaeadbdbdbdbdbdadaeaeadaeaeaeaeaeaeaeadaa
aaadaeaeaeaeafaeaeaeaeaeahbdbdbdbdbdahaeaeaeaeaeaeaeaeaeadaeaeaeaeaeaeaeaeaeadbdbdadadbdbdbdbdbdbdbdbdbdbdbdadadbdbdadaeaeaeaeaeaeaeaeaeadaeaeaeaeaeaeaeaeaeahbdbdbdbdbdahaeaeaeaeaeafaeaeaeaeadaa
aaadaeaeafafadaeaeaeaeaeadbdbdbdbdbeadagaeaeaeaeaeaeaeadadadadadadadadadaqadadbdbdbdadadbdbdbdbdbdbdbdbdbdadadbdbdbdadadaqadadadadadadadadadaeaeaeaeaeaeaeagadbebdbdbdbdadaeaeaeaeaeadafafaeaeadaa
aaadaeaeafadagaeaeadadadadbdbdbdadadadadadadaqaqadadadadbebdbdbdbdbdbdbdbdadbdbdbdbdbdbdbdbdbdbdbdbdbdbdbdbdbdbdbdbdbdadbdbdbdbdbdbdbdbdbeadadadadaqaqadadadadadadbdbdbdadadadadaeaeagadafaeaeadaa
aaadaeaeafafaeaeaeadbfbdbdbdbdbdbdbdbdbdbfbfbdbdbdbdbeadbdbdbdbdbdbdbdbdbdadbdbdadbdbdbdbdbdbdbdbdbdbdbdbdbdbdbdadbdbdadbdbdbdbdbdbdbdbdbdadbebdbdbdbdbfbfbdbdbdbdbdbdbdbdbdbfadaeaeaeafafaeaeadaa
aaadaeaeafafaeaeaeadbdbdbdbdbdbdbdbdbdbdbdbdbdbdbdbdbdadbdbdbfbfbfbdbdadadadbdbdbdbdbdbdbdbdadadadadadbdbdbdbdbdbdbdbdadadadbdbdbfbfbfbdbdadbdbdbdbdbdbdbdbdbdbdbdbdbdbdbdbdbdadaeaeaeafafaeaeadaa
aaadaeaeaebgaeaeaearbdbdbdbdbdbdadbdbdbdbdbdbdbdbdbdbdbdbdbdbdbfbfbdbdbdbdbfbdbdbdbdadadbdbdadbdbdbdadbdbdadadbdbdbdbdbdbdbdbdbdbfbfbdbdbdbdbdbdbdbdbdbdbdbdbdbdadbdbdbdbdbdbdasaeaeaebhaeaeaeadaa
aaadaeaeaeaeaeaeaearbdbdbdbdbdbdadbfbdbdbdbdbdbdbdbdbdbdbdbdbdadbdbdbdbdbdbdbdbdbdadadbdbdbdbdbdbdbdbdbdbdbdadadbdbdbdbdbdbdbdbdbdadbdbdbdbdbdbdbdbdbdbdbdbdbdbfadbdbdbdbdbdbdasaeaeaeaeaeaeaeadaa
aaadadaeaeaeafaeaeadbdbdbdbdbdbeadbfbfbdbdbdbdbdbdbdbdadbdbdbdbdbdbdbdbdbdbdbdbdadadbdbdadbdbdbdbdbdbdbdadbdbdadadbdbdbdbdbdbdbdbdbdbdbdbdadbdbdbdbdbdbdbdbdbfbfadbebdbdbdbdbdadaeaeafaeaeaeadadaa
aaadadadadadadadadadadadadadadadadadadadadadadadadadadadadadadadadadadadbdbdadadadbdbdbdadadbdbdbdbdbdadadbdbdbdadadadbdbdadadadadadadadadadadadadadadadadadadadadadadadadadadadadadadadadadadadaa
aaaaaaaaaaaaaaaaaaaaaaaaaaaaaaaaaaaaaaaaaaaaaaaaaaaaaaaaaaaaaaaaaaaaaaadbdbdbdadbdbdbdbdbdadbdbdbdbdbdadbdbdbdbdbdadbdbdbdadaaaaaaaaaaaaaaaaaaaaaaaaaaaaaaaaaaaaaaaaaaaaaaaaaaaaaaaaaaaaaaaaaaaaaa
bibibibibibibibibibibibibibibibibibibibibibibibibibibibibibibibibibiaaadadbdbdbdbdbdadbdbdbdbdbdbebdbdbdbdbdadbdbdbdbdbdadadaabibibibibibibibibibibibibibibibibibibibibibibibibibibibibibibibibibi
bibibibibibibibibibibibibibibibibibibibibibibibibibibibibibibibibibiaaaaadadadadadadadadadadadadadadadadadadadadadadadadadaaaabibibibibibibibibibibibibibibibibibibibibibibibibibibibibibibibibibi
bibibibibibibibibibibibibibibibibibibibibibibibibibibibibibibibibibibiaaaaaaaaaaaaaaaaaaaaaaaaaaaaaaaaaaaaaaaaaaaaaaaaaaaaaabibibibibibibibibibibibibibibibibibibibibibibibibibibibibibibibibibibi
"}
