"aa" = (/turf/closed/indestructible/riveted/TDM,/area/TDM)
"ab" = (/turf/closed/wall/rust,/area/TDM)
"ac" = (/turf/open/floor/plating/rust,/area/TDM)
"ad" = (/obj/machinery/power/emitter{active = 1; active_power_usage = 0; anchored = 1; idle_power_usage = 0; resistance_flags = 115; state = 2},/turf/open/floor/plating/rust,/area/TDM)
"ae" = (/obj/machinery/door/poddoor/TDM/fast/preopen{crush_damage = 40; id = "d1"},/turf/open/floor/plating/rust,/area/TDM)
"af" = (/obj/machinery/button/door{id = "d1"; sync_doors = 0},/turf/open/floor/plating/rust,/area/TDM)
"ag" = (/obj/machinery/door/poddoor/TDM/fast{crush_damage = 40; id = "d1"},/turf/open/floor/plating/rust,/area/TDM)
"ah" = (/obj/machinery/door/poddoor/TDM/fast{id = "d2"},/turf/open/floor/plating/rust,/area/TDM)
"ai" = (/obj/machinery/door/poddoor/TDM/fast/preopen{id = "d2"},/turf/open/floor/plating/rust,/area/TDM)
"aj" = (/obj/structure/ore_box/TDM,/turf/open/floor/plating/rust,/area/TDM)
"ak" = (/obj/machinery/door/poddoor/TDM/fast/preopen{id = "d3"},/turf/open/floor/plating/rust,/area/TDM)
"al" = (/obj/machinery/button/door{id = "d3"; sync_doors = 0},/turf/open/floor/plating/rust,/area/TDM)
"am" = (/turf/open/chasm,/area/TDM)
"an" = (/obj/effect/portal/permanent{id = "p1"},/obj/effect/turf_decal/bot,/turf/open/floor/plating/rust,/area/TDM)
"ao" = (/obj/machinery/button/door{id = "d2"; sync_doors = 0},/turf/open/floor/plating/rust,/area/TDM)
"ap" = (/obj/effect/portal/permanent{id = "p2"},/obj/effect/turf_decal/bot,/turf/open/floor/plating/rust,/area/TDM)
"aq" = (/obj/effect/turf_decal/stripes/line{dir = 8},/obj/machinery/conveyor/TDM/permanent{id = "c1"},/turf/open/floor/plating/rust,/area/TDM)
"ar" = (/obj/machinery/conveyor/TDM/permanent{id = "c1"},/turf/open/floor/plating/rust,/area/TDM)
"as" = (/obj/effect/turf_decal/stripes/line{dir = 4},/obj/machinery/conveyor/TDM/permanent{id = "c1"},/turf/open/floor/plating/rust,/area/TDM)
"at" = (/obj/effect/turf_decal/stripes/line{dir = 8},/obj/machinery/conveyor/TDM/permanent{dir = 1; id = "c1"},/turf/open/floor/plating/rust,/area/TDM)
"au" = (/obj/machinery/conveyor/TDM/permanent{dir = 1; id = "c1"},/turf/open/floor/plating/rust,/area/TDM)
"av" = (/obj/machinery/conveyor/TDM/permanent{dir = 1; id = "c1"},/obj/effect/turf_decal/stripes/line{dir = 4},/turf/open/floor/plating/rust,/area/TDM)
"aw" = (/obj/machinery/door/poddoor/TDM/fast{crush_damage = 40; id = "d2"},/turf/open/floor/plating/rust,/area/TDM)
"ax" = (/obj/machinery/conveyor/TDM/permanent{dir = 1; id = "c2"},/turf/open/floor/plating/rust,/area/TDM)
"ay" = (/obj/machinery/conveyor/TDM/permanent{dir = 1; id = "c2"},/obj/effect/turf_decal/stripes/line{dir = 4},/turf/open/floor/plating/rust,/area/TDM)
"az" = (/obj/effect/turf_decal/stripes/line{dir = 8},/obj/machinery/conveyor/TDM/permanent{id = "c2"},/turf/open/floor/plating/rust,/area/TDM)
"aA" = (/obj/machinery/conveyor/TDM/permanent{id = "c2"},/turf/open/floor/plating/rust,/area/TDM)
"aB" = (/obj/machinery/conveyor/TDM/permanent{id = "c2"},/obj/effect/turf_decal/stripes/line{dir = 4},/turf/open/floor/plating/rust,/area/TDM)
"aC" = (/obj/effect/turf_decal/stripes/line{dir = 1},/obj/machinery/conveyor/TDM/permanent{dir = 8; id = "c3"},/turf/open/floor/plating/rust,/area/TDM)
"aD" = (/obj/effect/turf_decal/caution{dir = 8},/turf/open/floor/plating/rust,/area/TDM)
"aE" = (/obj/machinery/conveyor_switch{id = "c3"; position = 1},/obj/effect/turf_decal/stripes/line{dir = 10},/obj/effect/turf_decal/stripes/line{dir = 1},/turf/open/floor/plating/rust,/area/TDM)
"aF" = (/obj/effect/portal/permanent{id = "p3"},/obj/effect/turf_decal/bot,/turf/open/floor/plating/rust,/area/TDM)
"aG" = (/obj/effect/portal/permanent{id = "p4"},/obj/effect/turf_decal/bot,/turf/open/floor/plating/rust,/area/TDM)
"aH" = (/obj/effect/turf_decal/caution{dir = 8; layer = 2.1; pixel_x = -8},/turf/closed/wall/rust,/area/TDM)
"aI" = (/obj/structure/window/plastitanium/tough/TDM,/obj/structure/grille,/turf/open/floor/sepia/TDM,/area/TDM)
"aJ" = (/obj/effect/turf_decal/stripes/line{dir = 8},/obj/machinery/conveyor/TDM/permanent{dir = 1; id = "c2"},/turf/open/floor/plating/rust,/area/TDM)
"aK" = (/obj/machinery/door/poddoor/TDM/fast/preopen{id = "d2"},/obj/item/assembly/mousetrap/armed,/turf/open/floor/plating/rust,/area/TDM)
"aL" = (/obj/effect/turf_decal/stripes/line{dir = 1},/turf/open/floor/plating/rust,/area/TDM)
"aM" = (/obj/machinery/button/door{id = "d1"; sync_doors = 0},/obj/effect/turf_decal/stripes/line{dir = 1},/obj/effect/turf_decal/stripes/box,/turf/open/floor/plating/rust,/area/TDM)
"aN" = (/obj/effect/turf_decal/stripes/corner{dir = 1},/turf/open/floor/plating/rust,/area/TDM)
"aO" = (/obj/machinery/button/door{id = "d2"; sync_doors = 0},/obj/effect/turf_decal/stripes/line{dir = 1},/obj/effect/turf_decal/stripes/box,/turf/open/floor/plating/rust,/area/TDM)
"aP" = (/obj/machinery/button/door{id = "d3"; sync_doors = 0},/obj/effect/turf_decal/stripes/line{dir = 1},/obj/effect/turf_decal/stripes/box,/turf/open/floor/plating/rust,/area/TDM)
"aQ" = (/obj/machinery/button/door{id = "d4"; sync_doors = 0},/turf/closed/wall/rust,/area/TDM)
"aR" = (/obj/machinery/door/poddoor/TDM/fast{id = "d4"},/turf/open/floor/plating/rust,/area/TDM)
"aS" = (/obj/machinery/conveyor_switch{id = "c1"; position = 1},/turf/open/floor/plating/rust,/area/TDM)
"aT" = (/obj/machinery/button/door{id = "d4"; sync_doors = 0},/obj/effect/turf_decal/stripes/line{dir = 6},/obj/effect/turf_decal/stripes/line{dir = 1},/turf/open/floor/plating/rust,/area/TDM)
"aU" = (/obj/effect/turf_decal/loading_area,/obj/effect/turf_decal/bot,/turf/open/floor/plating/rust,/area/TDM)
"aV" = (/obj/machinery/conveyor/TDM/permanent{dir = 1; id = "c6"},/obj/effect/turf_decal/stripes/line{dir = 4},/obj/effect/turf_decal/stripes/line{dir = 8},/turf/open/floor/plating/rust,/area/TDM)
"aW" = (/obj/machinery/conveyor_switch{id = "c2"; position = 1},/obj/effect/turf_decal/stripes/line{dir = 1},/obj/effect/turf_decal/stripes/box,/turf/open/floor/plating/rust,/area/TDM)
"aX" = (/obj/effect/turf_decal/stripes/line{dir = 4},/turf/open/floor/plating/rust,/area/TDM)
"aY" = (/turf/open/floor/holofloor/grass,/area/TDM)
"aZ" = (/obj/effect/turf_decal/loading_area{dir = 4},/obj/effect/turf_decal/bot,/turf/open/floor/plating/rust,/area/TDM)
"ba" = (/obj/effect/portal/permanent{id = "pbb"; name = "Blue Base"},/obj/effect/turf_decal/bot,/turf/open/floor/plating/rust,/area/TDM)
"bb" = (/obj/effect/portal/permanent{id = "pd1"; name = "Hallway B"},/obj/effect/turf_decal/bot,/turf/open/floor/plating/rust,/area/TDM)
"bc" = (/obj/effect/turf_decal/stripes/corner{dir = 4},/turf/open/floor/plating/rust,/area/TDM)
"bd" = (/obj/effect/portal/permanent{id = "p5"},/obj/effect/turf_decal/bot,/turf/open/floor/plating/rust,/area/TDM)
"be" = (/obj/effect/turf_decal/arrows{dir = 1; pixel_y = -4},/turf/open/floor/plating/rust,/area/TDM)
"bf" = (/obj/structure/TDM/spawn_protection/red,/obj/machinery/door/airlock/vault,/turf/open/floor/plating/rust,/area/TDM)
"bg" = (/turf/closed/wall/rust,/area/TDM/blue_base)
"bh" = (/obj/structure/flora/junglebush/b,/turf/open/floor/holofloor/grass,/area/TDM)
"bi" = (/obj/structure/flora/junglebush/large,/turf/open/floor/holofloor/grass,/area/TDM)
"bj" = (/obj/effect/turf_decal/stripes/line{dir = 8},/obj/machinery/conveyor/TDM/permanent{id = "c5"},/turf/open/floor/plating/rust,/area/TDM)
"bk" = (/obj/machinery/conveyor/TDM/permanent{id = "c5"},/turf/open/floor/plating/rust,/area/TDM)
"bl" = (/obj/item/grown/bananapeel{anchored = 1},/obj/effect/turf_decal/stripes/line{dir = 4},/obj/machinery/conveyor/TDM/permanent{id = "c5"},/turf/open/floor/plating/rust,/area/TDM)
"bm" = (/obj/effect/turf_decal/stripes/line{dir = 8},/obj/machinery/conveyor/TDM/permanent{dir = 1; id = "c5"},/turf/open/floor/plating/rust,/area/TDM)
"bn" = (/obj/machinery/conveyor/TDM/permanent{dir = 1; id = "c5"},/turf/open/floor/plating/rust,/area/TDM)
"bo" = (/obj/machinery/conveyor/TDM/permanent{dir = 1; id = "c5"},/obj/effect/turf_decal/stripes/line{dir = 4},/turf/open/floor/plating/rust,/area/TDM)
"bp" = (/obj/effect/turf_decal/stripes/line{dir = 8},/obj/machinery/conveyor/TDM/permanent{dir = 1; id = "c4"},/turf/open/floor/plating/rust,/area/TDM)
"bq" = (/obj/machinery/door/poddoor/TDM/fast/preopen{id = "d6"},/turf/open/floor/plating/rust,/area/TDM)
"br" = (/obj/machinery/button/door{id = "d6"; sync_doors = 0},/turf/open/floor/plating/rust,/area/TDM)
"bs" = (/obj/machinery/conveyor/TDM/permanent{dir = 1; id = "c4"},/turf/open/floor/plating/rust,/area/TDM)
"bt" = (/obj/machinery/conveyor/TDM/permanent{dir = 1; id = "c4"},/obj/effect/turf_decal/stripes/line{dir = 4},/turf/open/floor/plating/rust,/area/TDM)
"bu" = (/obj/effect/turf_decal/stripes/line{dir = 8},/obj/machinery/conveyor/TDM/permanent{id = "c4"},/turf/open/floor/plating/rust,/area/TDM)
"bv" = (/obj/machinery/door/poddoor/TDM/fast{id = "d5"},/turf/open/floor/plating/rust,/area/TDM)
"bw" = (/obj/machinery/conveyor/TDM/permanent{id = "c4"},/turf/open/floor/plating/rust,/area/TDM)
"bx" = (/obj/machinery/conveyor/TDM/permanent{id = "c4"},/obj/effect/turf_decal/stripes/line{dir = 4},/turf/open/floor/plating/rust,/area/TDM)
"by" = (/obj/machinery/conveyor/TDM/permanent{id = "c5"},/obj/effect/turf_decal/stripes/line{dir = 4},/turf/open/floor/plating/rust,/area/TDM)
"bz" = (/obj/structure/TDM/medical_cabinet{color = "#C4A39A"; pixel_x = -8},/obj/structure/TDM/wallmed{color = "#C4A39A"; pixel_x = 6},/turf/closed/wall,/area/TDM/blue_base)
"bA" = (/obj/structure/table/wood,/obj/item/candle/infinite{name = "cursed candle"; pixel_x = 2; pixel_y = 2},/obj/item/trash/candle{pixel_x = 9; pixel_y = 3},/obj/item/trash/candle{pixel_x = -6; pixel_y = 5},/turf/open/floor/carpet/royalblack,/area/TDM/blue_base)
"bB" = (/obj/item/clothing/head/helmet/skull{pixel_y = 5},/obj/structure/table/wood,/turf/open/floor/carpet/royalblack,/area/TDM/blue_base)
"bC" = (/obj/structure/closet/crate/coffin{anchored = 1},/obj/effect/temp_visual/cult/turf,/turf/open/floor/carpet/red,/area/TDM/blue_base)
"bD" = (/obj/machinery/clonepod/TDM/team_blue{color = "#C4A39A"; TDM_on = 1},/turf/open/floor/carpet/red,/area/TDM/blue_base)
"bE" = (/obj/structure/closet/crate/coffin,/obj/effect/temp_visual/cult/turf,/turf/open/floor/carpet/red,/area/TDM/blue_base)
"bF" = (/obj/item/clothing/head/helmet/skull{pixel_y = 5},/obj/structure/table/wood,/obj/item/trash/candle{pixel_x = 11; pixel_y = 2},/turf/open/floor/carpet/royalblack,/area/TDM/blue_base)
"bG" = (/obj/structure/table/wood,/obj/item/candle/infinite{name = "cursed candle"; pixel_x = 1; pixel_y = 5},/obj/item/trash/candle{pixel_x = -6; pixel_y = 5},/obj/item/trash/candle{pixel_x = 5; pixel_y = 4},/obj/item/candle/infinite{name = "cursed candle"; pixel_x = 8; pixel_y = 12},/turf/open/floor/carpet/royalblack,/area/TDM/blue_base)
"bH" = (/obj/structure/TDM/medical_cabinet{color = "#C4A39A"; pixel_x = 8},/obj/structure/TDM/wallmed{color = "#C4A39A"; pixel_x = -7},/turf/closed/wall,/area/TDM/blue_base)
"bI" = (/turf/closed/indestructible/riveted/TDM/wall,/area/TDM/red_base)
"bJ" = (/obj/structure/window/plastitanium/tough/TDM,/obj/structure/grille,/turf/open/floor/sepia/TDM,/area/TDM/red_base)
"bK" = (/obj/structure/mineral_door/iron/TDM,/obj/structure/TDM/spawn_protection/red,/obj/structure/fans/tiny,/turf/open/floor/sepia/TDM,/area/TDM/red_base)
"bL" = (/obj/item/banner/TDM/red,/turf/closed/indestructible/riveted/TDM/wall,/area/TDM/red_base)
"bM" = (/obj/structure/flora/tree/jungle/small,/turf/open/floor/holofloor/grass,/area/TDM)
"bN" = (/obj/effect/portal/permanent{id = "pf"},/obj/effect/turf_decal/bot,/turf/open/floor/plating/rust,/area/TDM)
"bO" = (/obj/machinery/conveyor_switch{id = "c5"; position = 1},/turf/open/floor/plating/rust,/area/TDM)
"bP" = (/obj/machinery/conveyor_switch{id = "c4"; position = 1},/obj/effect/turf_decal/stripes/line{dir = 6},/obj/effect/turf_decal/stripes/line{dir = 1},/turf/open/floor/plating/rust,/area/TDM)
"bQ" = (/obj/effect/portal/permanent{id = "p7"},/obj/effect/turf_decal/bot,/turf/open/floor/plating/rust,/area/TDM)
"bR" = (/obj/effect/portal/permanent{id = "p6"},/obj/effect/turf_decal/bot,/turf/open/floor/plating/rust,/area/TDM)
"bS" = (/turf/open/floor/carpet/royalblack,/area/TDM/blue_base)
"bT" = (/obj/structure/TDM/floodlight,/turf/open/indestructible,/area/TDM/red_base)
"bU" = (/turf/open/indestructible,/area/TDM/red_base)
"bV" = (/obj/machinery/button/door{id = "d5"; sync_doors = 0},/turf/open/floor/plating/rust,/area/TDM)
"bW" = (/obj/item/candle/infinite{name = "cursed candle"; pixel_y = 2},/obj/structure/table/wood/fancy/red{color = "#CDAA97"},/turf/open/floor/carpet/royalblack,/area/TDM/blue_base)
"bX" = (/obj/item/book{pixel_y = 6},/obj/structure/table/wood/fancy/red{color = "#CDAA97"},/turf/open/floor/carpet/royalblack,/area/TDM/blue_base)
"bY" = (/obj/structure/table/wood/fancy/red{color = "#CDAA97"},/obj/item/candle/infinite{name = "cursed candle"; pixel_y = 2},/turf/open/floor/carpet/royalblack,/area/TDM/blue_base)
"bZ" = (/turf/closed/indestructible/riveted/TDM/wall,/area/TDM)
"ca" = (/obj/effect/portal/permanent{id = "pd1"; name = "Hallway A"},/obj/effect/turf_decal/bot,/turf/open/floor/plating/rust,/area/TDM)
"cb" = (/obj/machinery/button/door{id = "d6"; sync_doors = 0},/obj/effect/turf_decal/stripes/line{dir = 1},/obj/effect/turf_decal/stripes/box,/turf/open/floor/plating/rust,/area/TDM)
"cc" = (/obj/effect/portal/permanent{id = "pbb"; name = "Start"},/obj/effect/turf_decal/bot,/turf/open/floor/plating/rust,/area/TDM)
"cd" = (/obj/effect/turf_decal/loading_area{dir = 8; pixel_x = 0},/obj/effect/turf_decal/bot,/turf/open/floor/plating/rust,/area/TDM)
"ce" = (/obj/structure/mineral_door/wood{color = "#C4A39A"},/turf/open/floor/carpet/royalblack,/area/TDM/blue_base)
"cf" = (/obj/effect/decal/remains/human{color = "#9E7658"},/turf/open/floor/carpet/royalblack,/area/TDM/blue_base)
"cg" = (/obj/effect/rune/raise_dead,/obj/item/kitchen/knife/ritual,/mob/living/simple_animal/hostile/retaliate/goat,/turf/open/floor/carpet/royalblack,/area/TDM/blue_base)
"ch" = (/obj/structure/TDM/medical_cabinet{pixel_x = 9},/obj/structure/TDM/wallmed{pixel_x = -6},/turf/closed/indestructible/riveted/TDM/wall,/area/TDM/red_base)
"ci" = (/obj/machinery/door/poddoor{id = "db"; resistance_flags = 115},/turf/open/floor/holofloor/grass,/area/TDM)
"cj" = (/obj/effect/turf_decal/stripes/line{dir = 1},/obj/effect/turf_decal/stripes/box,/obj/machinery/conveyor_switch{id = "c5"; position = 1},/turf/open/floor/plating/rust,/area/TDM)
"ck" = (/obj/effect/turf_decal/loading_area{dir = 1},/obj/effect/turf_decal/bot,/turf/open/floor/plating/rust,/area/TDM)
"cl" = (/obj/machinery/button/door{id = "d5"; sync_doors = 0},/obj/effect/turf_decal/stripes/line{dir = 10},/obj/effect/turf_decal/stripes/line{dir = 1},/turf/open/floor/plating/rust,/area/TDM)
"cm" = (/obj/effect/turf_decal/stripes/line{dir = 1},/obj/effect/turf_decal/stripes/box,/obj/machinery/conveyor_switch{id = "c6"; position = 1},/turf/open/floor/plating/rust,/area/TDM)
"cn" = (/turf/open/floor/carpet/red,/area/TDM/blue_base)
"co" = (/obj/structure/displaycase/TDM_item_spawn/revolver,/turf/open/indestructible,/area/TDM/red_base)
"cp" = (/obj/structure/displaycase/TDM_item_spawn/knife,/turf/open/indestructible,/area/TDM/red_base)
"cq" = (/obj/structure/flora/tree/jungle,/turf/open/floor/holofloor/grass,/area/TDM)
"cr" = (/obj/structure/chair/pew/left{dir = 1},/turf/open/floor/carpet/royalblack,/area/TDM/blue_base)
"cs" = (/obj/structure/chair/pew/right{dir = 1},/turf/open/floor/carpet/royalblack,/area/TDM/blue_base)
"ct" = (/obj/structure/displaycase/TDM_item_spawn/shotgun,/turf/open/indestructible,/area/TDM/red_base)
"cu" = (/obj/structure/displaycase/TDM_item_spawn/stechkin,/turf/open/indestructible,/area/TDM/red_base)
"cv" = (/obj/effect/turf_decal/bot,/turf/closed/wall/rust,/area/TDM)
"cw" = (/obj/structure/displaycase/TDM_item_spawn/APS,/turf/open/indestructible,/area/TDM/red_base)
"cx" = (/obj/structure/displaycase/TDM_item_spawn/m1911,/turf/open/indestructible,/area/TDM/red_base)
"cy" = (/obj/structure/flora/junglebush/c,/turf/open/floor/holofloor/grass,/area/TDM)
"cz" = (/obj/structure/chair/pew/left{dir = 1},/obj/item/flashlight/lantern/on{pixel_x = -12},/turf/open/floor/carpet/royalblack,/area/TDM/blue_base)
"cA" = (/obj/structure/chair/pew/right{dir = 1},/obj/item/flashlight/lantern/on{pixel_x = 12},/turf/open/floor/carpet/royalblack,/area/TDM/blue_base)
"cB" = (/obj/machinery/clonepod/TDM/team_red{TDM_on = 1},/turf/open/indestructible,/area/TDM/red_base)
"cC" = (/obj/structure/displaycase/TDM_item_spawn/shield,/turf/open/indestructible,/area/TDM/red_base)
"cD" = (/obj/structure/displaycase/TDM_item_spawn/carbine,/turf/open/indestructible,/area/TDM/red_base)
"cE" = (/obj/structure/displaycase/TDM_item_spawn/deagle,/turf/open/indestructible,/area/TDM/red_base)
"cF" = (/obj/structure/displaycase/TDM_item_spawn/bolt_action,/turf/open/indestructible,/area/TDM/red_base)
"cG" = (/obj/structure/displaycase/TDM_item_spawn/sniper,/turf/open/indestructible,/area/TDM/red_base)
"cH" = (/obj/structure/table/wood,/obj/item/reagent_containers/food/snacks/grown/poppy,/turf/open/floor/carpet/royalblack,/area/TDM/blue_base)
"cI" = (/obj/item/flashlight/lantern/on,/turf/open/floor/carpet/royalblack,/area/TDM/blue_base)
"cJ" = (/obj/structure/displaycase/TDM_item_spawn/uzi,/turf/open/indestructible,/area/TDM/red_base)
"cK" = (/obj/structure/displaycase/TDM_item_spawn/c20r,/turf/open/indestructible,/area/TDM/red_base)
"cL" = (/obj/structure/mineral_door/wood{color = "#C4A39A"},/turf/open/floor/carpet/red,/area/TDM/blue_base)
"cM" = (/obj/machinery/button/door{id = "db"; pixel_x = -24; sync_doors = 0},/turf/open/floor/holofloor/grass,/area/TDM)
"cN" = (/obj/structure/flora/junglebush/large,/obj/item/clothing/shoes/clown_shoes,/turf/open/floor/holofloor/grass,/area/TDM)
"cO" = (/obj/item/clothing/shoes/sandal,/turf/open/floor/plating/rust,/area/TDM)
"cP" = (/obj/item/clothing/shoes/galoshes,/turf/open/floor/plating/rust,/area/TDM)
"cQ" = (/obj/item/clothing/shoes/sneakers/rainbow,/turf/open/floor/plating/rust,/area/TDM)
"cR" = (/obj/item/clothing/shoes/jackboots,/turf/open/floor/plating/rust,/area/TDM)
"cS" = (/obj/structure/TDM/spawn_protection/red,/obj/structure/mineral_door/iron/TDM,/turf/open/floor/plating/rust,/area/TDM)
"cT" = (/obj/item/clothing/shoes/sneakers/white,/turf/open/floor/plating/rust,/area/TDM)
"cU" = (/obj/item/clothing/shoes/winterboots,/turf/open/floor/plating/rust,/area/TDM)
"cV" = (/obj/effect/portal/permanent{id = "pf"},/turf/open/floor/plating/rust,/area/TDM)
"cW" = (/obj/item/clothing/shoes/sneakers/green,/turf/open/floor/plating/rust,/area/TDM)
"cX" = (/obj/item/clothing/shoes/workboots,/turf/open/floor/plating/rust,/area/TDM)
"cY" = (/turf/template_noop,/area/template_noop)
"cZ" = (/obj/item/assembly/mousetrap/armed,/turf/open/floor/plating/rust,/area/TDM)
"da" = (/obj/machinery/door/poddoor/TDM/fast/preopen{id = "d3"},/obj/item/assembly/mousetrap/armed,/turf/open/floor/plating/rust,/area/TDM)
"db" = (/obj/machinery/door/poddoor/TDM/fast{id = "d4"},/obj/item/assembly/mousetrap/armed,/turf/open/floor/plating/rust,/area/TDM)
"dc" = (/obj/machinery/conveyor_switch{id = "c1"; position = 1},/obj/effect/turf_decal/stripes/line{dir = 1},/obj/effect/turf_decal/stripes/box,/turf/open/floor/plating/rust,/area/TDM)
"dd" = (/obj/machinery/door/poddoor/TDM/fast/preopen{id = "d6"},/obj/item/assembly/mousetrap/armed,/turf/open/floor/plating/rust,/area/TDM)
"de" = (/turf/open/floor/plating/asteroid,/area/TDM)
"df" = (/turf/open/floor/plating/asteroid/basalt,/area/TDM)
"dg" = (/obj/structure/railing{dir = 1; resistance_flags = 115},/turf/open/floor/holofloor/grass,/area/TDM)
"dh" = (/turf/open/floor/holofloor/grass,/area/space)
"di" = (/obj/item/clothing/head/crown{resistance_flags = 115},/turf/open/floor/plating/rust,/area/TDM)
"dj" = (/obj/structure/TDM_dresser,/turf/open/indestructible,/area/TDM/red_base)

(1,1,1) = {"
aaaaaaaaaaaaaaaaaaaaaaaaaaaaaaaaaaaaaaaaaaaaaaaaaaaaaaaaaaaaaaaaaaaaaaaaaaaaaaaaaaaaaaaaaaaaaaaaaaaaaaaaaaaaaaaaaaaaaaaaaaaaaaaaaaaaaaaaaaaaaaaaaaaaaaaaaaaaaaaaaaaaaaaaaaaaaaaaaaaaaaaaaaaaaaaaaa
aaabababababababababababababababababababababababababababababababababababababababababababababababababababababababababababababababababababababababababababababababababababababababababababababababaa
aaabacacacacacacacacabacacacacadacacaeaeafagacacacacacawacaiahacacacajacacacacakajakalakacacajacacacabababababamamamamamamamababababababababamamamamamamamamamabababababababababababababababababaa
aaabacacacacacacacacabanacacacacacacaeaeacagacacacacaoawacaKahacacacacacacacajakalakajakacacacacacapabacacacacaqarascZatauavacacacacabacacacacaJaxayacazaAaBacacacacabacacacaCaCaCaCaCaCaCaCamabaa
aaabacacacacacacacacabacacacacacacafaeaeacagacacacacacawaoaiahacacacacajacacalakajdaalakajacacacacacabapacacaDaqarasaSatauavacacacaFabaFacacacaJaxayacazaAaBacacacaGabaGacacaCaCaCaCaCaCaCaCamaHaa
aaabacacacacacacacacabababababababaIaIaIaIaIaIabababaIaIaIaIaIabababababababaIaIaIaIaIababababababababacacacacaqarasacatauavacacacacabacacacacaJaxayacazaAaBacacacacabacacacaCaCaCaCaCaCaCaCamabaa
aaabacacacacacacacacabacacacacacbcaLaLaLaLaMaLaNacbcaLaLaLaLaOaNacacacacacbcaLaLaPaLaLaNacacacacacacabababababamamamamamamamababababababababamamamamamamamamamabababababababaIaIaIaIaQdbaRaRababaa
aaabacacacacacacacacabacacacacacacacacacacacacacacacacacacacacacacacacacacacacacacacacacacacacacacacacacacacabaIaIaIaIaIaIaIabacacacacacacabaIaIaIaIaIaIaIaIaIabacacacacacbcaLaLaEaTaIacacacababaa
aaabacacacacacacacacabacacacacacacacacabababababababababababacacacababacacacacacacacacacacacacacacaUacacacacbcaLaLaLdcaLaLaLaNacacacacacacbcaLaLaLaLaWaLaLaLaLaNacacacacacacacacacaXaIacacacababaa
aaababababababacacacabacacacacacacacacabacacacacacacacacacabacacaZbaabababacacacacacacacacacabababbbabacacacacacacacacacacacacacacacacacacacacacacacacacacacacacacacacacacacacacacbcabacbdacababaa
aaababanababababacacabacacacacacacacacabacacacacacacacacacabacacabababababababababababababababababababababababababababababababababababababababababababababababababababacacacababababababababababaa
aaabacbeacacacabacacababababbfabababababacacacacacaccZacacabacacabamamamamamamamamamamamamamamabababababababababababababababababababababababababamamamamamamamababababacacbgbgbgbgbgbgbgbgbgbgbgaa
aaabacacacacacabacacabbhaYaYaYaYbiaYbiabacacacacacacacacacabacacabamamaVacacacbjbkblacbmbnboacacacabacacacamacbqbqacbqambqcZbqbramacacacabacacacbpbsbtbvbubwbxacacacabacacbgbzbAbBbCbDbEbFbGbHbgaa
aabIbIbJbIbKbIbIbIbLabaYbMaYaYaYaYbMbiabdedeamamdfdfacacacabacacabbNacaVamacacbjbkbybObmbnboacacbQabbQacacacacbqbqambqbrbqambqacacacacbRabbRacacbpbsbtacbubwbxacacbdabacacbgbSbSbSbSbSbSbSbSbSbgaa
aabIbTbUbUbUbUbUbTbIbIaYaYaYaYaYaYaYaYabdedeamamdfdfacacacabacacabamamaVacacacbjbkbyacbmbnboacacacabacacacacamddbqbrbqambqbrbqamacacacacabacacbVbpbsbtbvbubwbxacacacabacacbgbSbSbSbSbSbSbSbSbSbgaa
aabIbUbUbUbUbUbUbUbTbIbiaYaYaYaYaYaYaYabababababababababababacacabamamamamamamamamamamamamamamabababababaIaIaIaIaIaIaIaIaIaIaIaIaIaIababababababamamamamamamamababababacacbgbSbSbSbWbXbYbSbSbSbgaa
aabIbUbUbUbUbUbUbUbUbIbZaYaYaYaYaYaYaYabaYaYaYaYaYaYaYaYaYabacacabababaIaIaIaIaIaIaIaIaIaIaIababcaabacbcaLaLaLcbaLaLaLaLaLcbaLaLaLaLaNacacacacabaIaIaIaIaIaIaIabcccdacacaccebSbScfbScgbSbSbSbSbgaa
aabIdjbUbUchbIbUbUbUbKcibhaYaYaYaYaYaYabaYaYaYaYaYaYaYaYaYabacacacacbcaLcmaNbcaLaLaLcjaLaLaLaNacckacacacacacacacacacacacacacacacacacacacacacacbcaLaLclbPaLaLaLaNacacacacacbgbSbSbScncncnbSbSbSbgaa
aabIcobUbUcpbIbUbUbUbKciaYaYbiaYcqaYaYabaYaYaYaYaYaYaYaYaYabacacacacacacacacacacacacacacacacacacacacacacacacacacacacacacacacacacacacacacacacacacacacacacacacacacacacacacacbgbScrcscncncncrcsbSbgaa
aabLctbUbUcubLbUbUbUbIbZaYaYaYaYaYaYaYabaYaYaYaYaYaYaYaYaYabababababababababababababababababababababababababababababababababababababababababababababababababababababcvacacbgbSbSbScncncnbSbSbSbgaa
aabIcwbUbUcxbIbUbUbUbIbiaYaYaYcyaYaYbiabaYaYaYaYaYaYaYaYaYaYaYaYaYaYaYaYaYaYaYaYaYaYaYaYaYaYaYaYaYaYaYaYaYaYaYaYaYaYaYaYaYaYaYaYaYaYaYaYaYaYaYaYaYaYaYaYaYaYaYaYaYaYabacacbgbSczcscncncncrcAbSbgaa
aabIbTbUbUcBbIbUbUbUbJaYaYaYaYaYaYaYaYabaYaYaYaYaYaYaYaYaYaYaYaYaYaYaYaYaYaYaYaYaYaYaYaYaYaYaYaYaYaYaYaYaYaYaYaYaYaYaYaYaYaYaYaYaYaYaYaYaYaYaYaYaYaYaYaYaYaYaYaYaYaYabacacbgbSbSbScncncnbSbSbSbgaa
aabIcCbUbUbUbIbUbUbUbJaYcqaYaYaYaYaYaYabaYaYaYaYaYdhaYaYaYaYaYaYaYaYaYaYaYaYaYaYaYaYaYaYaYaYaYaYaYaYaYaYaYaYaYaYaYaYaYaYaYaYaYaYaYaYaYaYaYaYaYaYaYaYaYaYaYaYaYaYaYaYabacacbgbScrcscncncncrcsbSbgaa
aabIbTbUbUcBbIbUbUbUbJaYaYbiaYaYaYaYcqabaYaYaYaYaYaYaYaYaYaYaYaYaYaYaYaYaYaYaYaYaYaYaYaYaYaYaYaYaYaYaYaYaYaYaYaYaYaYaYaYaYaYaYaYaYaYaYaYaYaYaYaYaYaYaYaYaYaYaYaYaYaYabacacbgbSbSbScncncncfbSbSbgaa
aabIcDbUbUcEbIbUbUbUbIbhaYaYaYbMaYaYaYabaYaYaYaYaYaYaYaYaYaYaYaYaYaYaYaYaYaYaYaYaYaYaYaYaYaYaYaYaYaYaYaYaYaYaYaYaYaYaYaYaYaYaYaYaYaYaYaYaYaYaYaYaYaYaYaYaYaYaYaYaYaYabacacbgbSbScncncncncnbSbSbgaa
aabLcFbUbUcGbLbUbUbUbIbZaYaYaYaYaYaYaYabaYaYaYaYaYaYaYaYaYaYaYaYaYaYaYaYaYaYaYaYaYaYaYaYaYaYaYaYaYaYaYaYaYaYaYaYaYaYaYaYaYaYaYaYaYaYaYaYaYaYaYaYaYaYaYaYaYaYaYaYaYaYabacacbgcHcIcncncncncncIcHbgaa
aabIcJbUbUcKbIbUbUbUbKcibMaYbhaYaYaYaYabaYaYaYaYaYaYaYaYaYaYaYaYaYaYaYaYaYaYaYaYaYaYaYaYaYaYaYaYaYaYaYaYaYaYaYaYaYaYaYaYaYaYaYaYaYaYaYaYaYaYaYaYaYaYaYaYaYaYaYaYaYaYabacacbgbgbgcLcLbgcLcLbgbgbgaa
aabIbUbUbUchbIbUbUbUbKciaYaYaYaYaYbibiabaYaYaYaYaYaYaYaYaYaYaYaYaYaYaYaYaYaYaYaYaYaYaYaYaYaYaYaYaYaYaYaYaYaYaYaYaYaYaYaYaYaYaYaYaYaYaYaYaYaYaYaYaYaYaYaYaYaYaYaYaYaYabacacacacacacacacacacacacabaa
aabIbUbUbUbUbUbUbUbUbIbZaYaYaYaYcqaYbiabaYaYaYaYaYaYaYaYaYaYaYaYaYaYaYaYaYaYaYaYaYaYaYaYaYaYaYaYaYaYaYaYaYaYaYaYaYaYaYaYaYaYaYaYaYaYaYaYaYaYaYaYaYaYaYaYaYaYaYaYaYaYabacacacacacacacacacacacacabaa
aabIbUbUbUbUbUbUbUbTbIbiaYaYaYaYaYaYaYabaYaYaYaYaYaYaYaYaYaYaYaYaYaYaYaYaYaYaYaYaYaYaYaYaYaYaYaYaYaYaYaYaYaYaYaYaYaYaYaYaYaYaYaYaYaYaYaYaYaYaYaYaYaYaYaYaYaYaYaYaYaYababacacacacacacacacacacacabaa
aabIbTbUbUbUbUbUbTbIbLaYaYaYaYaYaYaYaYabaYaYaYaYaYaYaYaYaYaYaYamamamamamamamamamamamamamamamamamamamamamamamamamamamamamamamamaYaYaYaYaYaYaYaYaYaYaYaYaYaYaYaYaYaYaYababababababababababababababaa
aabIbIbJbIbKbIbIbIbIbiaYaYaYaYaYaYaYbiabaYaYaYaYaYaYaYaYaYaYaYamamamamamamamamamamamamamamamamamamamamamamamamamamamamamamamamaYaYaYaYaYaYaYaYaYaYaYaYaYaYaYaYaYaYaYaYaYaYaYaYaYaYaYaYaYaYaYaYabaa
aabZbiaYbZcibZbibZaYaYaYaYaYaYaYbMaYaYabaYaYaYaYaYaYaYaYaYaYaYamamamamamamamamamamamamamamamamamamamamamamamamamamamamamamamamaYaYaYaYaYaYaYaYaYaYaYaYaYaYaYaYaYaYaYaYaYaYaYaYaYaYaYaYaYaYaYaYabaa
aabZcMaYbMaYaYaYbZaYaYaYaYbhaYaYaYaYaYabaYaYaYaYaYaYaYaYaYaYaYdgdgdgdgdgdgdgdgdgdgdgdgdgdgdgdgdgdgdgdgdgdgdgdgdgdgdgdgdgdgdgdgaYaYaYaYaYaYaYaYaYaYaYaYaYaYaYaYaYaYaYaYaYaYaYaYaYaYaYaYaYaYaYaYabaa
aabZaYaYaYaYaYaYciaYbMaYaYaYaYaYaYaYaYabaYaYaYaYaYaYaYaYaYaYaYaYaYaYaYaYaYaYaYaYaYaYaYaYaYaYaYaYaYaYaYaYaYaYaYaYaYaYaYaYaYaYaYaYaYaYaYaYaYaYaYaYaYaYaYaYaYaYaYaYaYaYaYaYaYaYaYaYaYaYaYaYaYaYaYabaa
aabZaYaYaYaYaYaYciaYaYaYaYaYaYaYaYaYaYabaYaYaYaYaYaYaYaYaYaYaYaYaYaYaYaYaYaYaYaYaYaYaYaYaYaYaYaYaYaYaYaYaYaYaYaYaYaYaYaYaYaYaYaYaYaYaYaYaYaYaYaYaYaYaYaYaYaYaYaYaYaYaYaYaYaYaYaYaYaYaYaYaYaYaYabaa
aabZaYaYaYaYaYaYbZaYaYaYaYaYaYaYaYaYbiabaYaYaYaYaYaYaYaYaYaYaYaYaYaYaYaYaYaYaYaYaYaYaYaYaYaYaYaYaYaYaYaYaYaYaYaYaYaYaYaYaYaYaYaYaYaYaYaYaYaYaYaYaYaYaYaYaYaYaYaYaYaYaYaYaYaYaYaYaYaYaYaYaYaYaYabaa
aabZcqaYaYaYaYbhbZbiaYaYbMaYaYcNaYcqbiabaYaYaYaYaYaYaYaYaYaYaYaYaYaYaYaYaYaYaYaYaYaYaYaYaYaYaYaYaYaYaYaYaYaYaYaYaYaYaYaYaYaYaYaYaYaYaYaYaYaYaYaYaYaYaYaYaYaYaYaYaYaYaYaYaYaYaYaYaYaYaYaYaYaYaYabaa
aabZaYaYaYaYabababababababaIaIaIababababaYaYaYaYaYaYaYaYaYaYaYaYaYaYaYaYaYaYaYaYaYaYaYaYaYaYaYaYaYaYaYaYaYaYaYaYaYaYaYaYaYaYaYaYaYaYaYaYaYaYaYaYaYaYaYaYaYaYaYaYaYaYaYaYaYaYaYaYaYaYaYaYaYaYaYabaa
aabZbhcqaYaYabcOaccPaccQacaccRcRaccUacabaYaYaYaYaYaYaYaYaYaYaYaYaYaYaYaYaYaYaYaYaYaYaYaYaYaYaYaYaYaYaYaYaYaYaYaYaYaYaYaYaYaYaYaYaYaYaYaYaYaYaYaYaYaYaYaYaYaYaYaYaYaYaYaYaYaYaYaYaYaYaYaYaYaYaYabaa
aabZbibhaYaYcSacaccTacaccOacacacdiaccVabaYaYaYaYaYaYaYaYaYaYaYaYaYaYaYaYaYaYaYaYaYaYaYaYaYaYaYaYaYaYaYaYaYaYaYaYaYaYaYaYaYaYaYaYaYaYaYaYaYaYaYaYaYaYaYaYaYaYaYaYaYaYaYaYaYaYaYaYaYaYaYaYaYaYaYabaa
aabZbZbiaYbhabcWacaccRacaccXaccOacaccRabaYaYaYaYaYaYaYaYaYaYaYaYaYaYaYaYaYaYaYaYaYaYaYaYaYaYaYaYaYaYaYaYaYaYaYaYaYaYaYaYaYaYaYaYaYaYaYaYaYaYaYaYaYaYaYaYaYaYaYaYaYaYaYaYaYaYaYaYaYaYaYaYaYaYaYabaa
aabZbZbZbZbZababababababababababababababababababababababababababababababaYaYaYaYaYaYaYaYaYaYaYaYaYaYaYaYaYaYaYaYaYaYaYaYaYabababababababababababababababababababababababababababababababababababaa
aaaaaaaaaaaaaaaaaaaaaaaaaaaaaaaaaaaaaaaaaaaaaaaaaaaaaaaaaaaaaaaaaaaaaaabaYaYaYaYaYaYaYaYaYaYaYaYaYaYaYaYaYaYaYaYaYaYaYaYaYabaaaaaaaaaaaaaaaaaaaaaaaaaaaaaaaaaaaaaaaaaaaaaaaaaaaaaaaaaaaaaaaaaaaaaa
cYcYcYcYcYcYcYcYcYcYcYcYcYcYcYcYcYcYcYcYcYcYcYcYcYcYcYcYcYcYcYcYcYcYaaababaYaYaYaYaYaYaYaYaYaYaYaYaYaYaYaYaYaYaYaYaYaYaYababaacYcYcYcYcYcYcYcYcYcYcYcYcYcYcYcYcYcYcYcYcYcYcYcYcYcYcYcYcYcYcYcYcYcY
cYcYcYcYcYcYcYcYcYcYcYcYcYcYcYcYcYcYcYcYcYcYcYcYcYcYcYcYcYcYcYcYcYcYaaaaababababababababababababaYababababababababababababaaaacYcYcYcYcYcYcYcYcYcYcYcYcYcYcYcYcYcYcYcYcYcYcYcYcYcYcYcYcYcYcYcYcYcY
cYcYcYcYcYcYcYcYcYcYcYcYcYcYcYcYcYcYcYcYcYcYcYcYcYcYcYcYcYcYcYcYcYcYcYaaaaaaaaaaaaaaaaaaaaaaaaaaaaaaaaaaaaaaaaaaaaaaaaaaaaaacYcYcYcYcYcYcYcYcYcYcYcYcYcYcYcYcYcYcYcYcYcYcYcYcYcYcYcYcYcYcYcYcYcYcY
"}
