"aa" = (/turf/closed/indestructible/riveted/TDM,/area/TDM)
"ab" = (/turf/closed/wall/rust,/area/TDM)
"ac" = (/turf/open/floor/sepia/TDM,/area/TDM)
"ad" = (/obj/structure/ore_box/TDM,/turf/open/floor/sepia/TDM,/area/TDM)
"ae" = (/obj/structure/TDM/floodlight,/turf/open/floor/sepia/TDM,/area/TDM)
"af" = (/obj/machinery/gateway{dir = 9},/turf/closed/wall/rust,/area/TDM)
"ag" = (/obj/machinery/gateway{dir = 1},/turf/closed/wall/rust,/area/TDM)
"ah" = (/obj/machinery/gateway{dir = 5},/turf/closed/wall/rust,/area/TDM)
"ai" = (/obj/structure/barricade/sandbags/TDM,/turf/open/floor/sepia/TDM,/area/TDM)
"aj" = (/obj/machinery/gateway{dir = 8},/turf/open/floor/sepia/TDM,/area/TDM)
"ak" = (/obj/effect/portal/permanent{icon_state = "portal"; id = "dust1_p_1"; name = "portal"; pixel_y = 9},/obj/machinery/gateway/centerstation{density = 0; layer = 3.1; level = 2},/turf/open/floor/sepia/TDM,/area/TDM)
"al" = (/obj/machinery/power/port_gen/pacman{anchored = 1; resistance_flags = 115},/obj/machinery/gateway{dir = 4},/turf/open/floor/sepia/TDM,/area/TDM)
"am" = (/obj/machinery/gateway,/turf/open/floor/sepia/TDM,/area/TDM)
"an" = (/turf/open/floor/plasteel/stairs/TDM/sepia/up,/area/TDM)
"ao" = (/turf/open/floor/plating/asteroid,/area/TDM)
"ap" = (/obj/structure/TDM/floodlight,/turf/open/floor/plating/asteroid,/area/TDM)
"aq" = (/obj/structure/ore_box/TDM,/turf/open/floor/plating/asteroid,/area/TDM)
"ar" = (/obj/structure/window/plastitanium/tough/TDM,/obj/structure/grille,/turf/open/floor/sepia/TDM,/area/TDM)
"as" = (/turf/open/floor/plasteel/stairs/TDM/sepia/left,/area/TDM)
"at" = (/turf/open/floor/plasteel/stairs/TDM/sepia/right,/area/TDM)
"au" = (/obj/structure/barricade/sandbags/TDM,/turf/open/floor/plating/asteroid,/area/TDM)
"av" = (/turf/closed/indestructible/riveted/TDM/wall,/area/TDM/red_base)
"aw" = (/obj/structure/window/plastitanium/tough/TDM,/obj/structure/grille,/turf/open/floor/sepia/TDM,/area/TDM/red_base)
"ax" = (/obj/structure/mineral_door/iron/TDM,/obj/structure/TDM/spawn_protection/red,/obj/structure/fans/tiny/invisible,/turf/open/floor/sepia/TDM,/area/TDM/red_base)
"ay" = (/obj/item/banner/TDM/red,/turf/closed/indestructible/riveted/TDM/wall,/area/TDM/red_base)
"az" = (/obj/item/banner/TDM/blue,/turf/closed/indestructible/riveted/TDM/wall,/area/TDM/blue_base)
"aA" = (/turf/closed/indestructible/riveted/TDM/wall,/area/TDM/blue_base)
"aB" = (/obj/structure/mineral_door/iron/TDM,/obj/structure/TDM/spawn_protection/blue,/obj/structure/fans/tiny/invisible,/turf/open/floor/sepia/TDM,/area/TDM/blue_base)
"aC" = (/obj/structure/window/plastitanium/tough/TDM,/obj/structure/grille,/turf/open/floor/sepia/TDM,/area/TDM/blue_base)
"aD" = (/obj/structure/TDM/floodlight,/turf/open/indestructible,/area/TDM/red_base)
"aE" = (/turf/open/indestructible,/area/TDM/red_base)
"aF" = (/obj/structure/TDM/floodlight,/turf/open/indestructible,/area/TDM/blue_base)
"aG" = (/turf/open/indestructible,/area/TDM/blue_base)
"aH" = (/turf/closed/mineral/has_air,/area/TDM)
"aI" = (/obj/structure/TDM/medical_cabinet{pixel_x = 9},/obj/structure/TDM/wallmed{pixel_x = -6},/turf/closed/indestructible/riveted/TDM/wall,/area/TDM/red_base)
"aJ" = (/obj/structure/TDM/medical_cabinet{pixel_x = -9},/obj/structure/TDM/wallmed{pixel_x = 6},/turf/closed/indestructible/riveted/TDM/wall,/area/TDM/blue_base)
"aK" = (/obj/structure/displaycase/TDM_item_spawn/revolver,/turf/open/indestructible,/area/TDM/red_base)
"aL" = (/obj/structure/displaycase/TDM_item_spawn/knife,/turf/open/indestructible,/area/TDM/red_base)
"aM" = (/obj/structure/displaycase/TDM_item_spawn/knife,/turf/open/indestructible,/area/TDM/blue_base)
"aN" = (/obj/structure/displaycase/TDM_item_spawn/revolver,/turf/open/indestructible,/area/TDM/blue_base)
"aO" = (/obj/structure/displaycase/TDM_item_spawn/shotgun,/turf/open/indestructible,/area/TDM/red_base)
"aP" = (/obj/structure/displaycase/TDM_item_spawn/stechkin,/turf/open/indestructible,/area/TDM/red_base)
"aQ" = (/obj/structure/displaycase/TDM_item_spawn/stechkin,/turf/open/indestructible,/area/TDM/blue_base)
"aR" = (/obj/structure/displaycase/TDM_item_spawn/shotgun,/turf/open/indestructible,/area/TDM/blue_base)
"aS" = (/obj/structure/displaycase/TDM_item_spawn/APS,/turf/open/indestructible,/area/TDM/red_base)
"aT" = (/obj/structure/displaycase/TDM_item_spawn/m1911,/turf/open/indestructible,/area/TDM/red_base)
"aU" = (/turf/open/chasm/jungle{initial_gas_mix = "o2=22;n2=82;TEMP=293.15"},/area/TDM)
"aV" = (/obj/structure/displaycase/TDM_item_spawn/m1911,/turf/open/indestructible,/area/TDM/blue_base)
"aW" = (/obj/structure/displaycase/TDM_item_spawn/APS,/turf/open/indestructible,/area/TDM/blue_base)
"aX" = (/obj/machinery/clonepod/TDM/team_red{TDM_on = 1},/turf/open/indestructible,/area/TDM/red_base)
"aY" = (/obj/structure/lattice/catwalk,/turf/open/chasm/jungle{initial_gas_mix = "o2=22;n2=82;TEMP=293.15"},/area/TDM)
"aZ" = (/obj/machinery/clonepod/TDM/team_blue{TDM_on = 1},/turf/open/indestructible,/area/TDM/blue_base)
"ba" = (/obj/structure/displaycase/TDM_item_spawn/shield,/turf/open/indestructible,/area/TDM/red_base)
"bb" = (/obj/structure/displaycase/TDM_item_spawn/shield,/turf/open/indestructible,/area/TDM/blue_base)
"bc" = (/obj/structure/barricade/wooden,/turf/open/floor/plating/asteroid,/area/TDM)
"bd" = (/obj/structure/fluff/drake_statue/falling{resistance_flags = 115},/turf/open/floor/plating/asteroid,/area/TDM)
"be" = (/obj/structure/displaycase/TDM_item_spawn/carbine,/turf/open/indestructible,/area/TDM/red_base)
"bf" = (/obj/structure/displaycase/TDM_item_spawn/deagle,/turf/open/indestructible,/area/TDM/red_base)
"bg" = (/obj/structure/displaycase/TDM_item_spawn/deagle,/turf/open/indestructible,/area/TDM/blue_base)
"bh" = (/obj/structure/displaycase/TDM_item_spawn/carbine,/turf/open/indestructible,/area/TDM/blue_base)
"bi" = (/obj/structure/displaycase/TDM_item_spawn/bolt_action,/turf/open/indestructible,/area/TDM/red_base)
"bj" = (/obj/structure/displaycase/TDM_item_spawn/sniper,/turf/open/indestructible,/area/TDM/red_base)
"bk" = (/obj/structure/displaycase/TDM_item_spawn/sniper,/turf/open/indestructible,/area/TDM/blue_base)
"bl" = (/obj/structure/displaycase/TDM_item_spawn/bolt_action,/turf/open/indestructible,/area/TDM/blue_base)
"bm" = (/obj/structure/displaycase/TDM_item_spawn/uzi,/turf/open/indestructible,/area/TDM/red_base)
"bn" = (/obj/structure/displaycase/TDM_item_spawn/c20r,/turf/open/indestructible,/area/TDM/red_base)
"bo" = (/obj/structure/stone_tile/block/cracked,/turf/open/floor/plating/asteroid,/area/TDM)
"bp" = (/obj/structure/displaycase/TDM_item_spawn/c20r,/turf/open/indestructible,/area/TDM/blue_base)
"bq" = (/obj/structure/displaycase/TDM_item_spawn/uzi,/turf/open/indestructible,/area/TDM/blue_base)
"br" = (/obj/structure/stone_tile/block,/turf/open/floor/plating/asteroid,/area/TDM)
"bs" = (/obj/structure/window/plastitanium/tough/TDM,/obj/structure/grille,/turf/open/floor/sepia/TDM/dark_10,/area/TDM)
"bt" = (/turf/open/floor/sepia/TDM/dark_10,/area/TDM)
"bu" = (/obj/structure/TDM/floodlight,/turf/open/floor/sepia/TDM/dark_10,/area/TDM)
"bv" = (/obj/structure/ore_box/TDM{color = "#e6e6e6"},/turf/open/floor/sepia/TDM/dark_10,/area/TDM)
"bw" = (/obj/item/banner/TDM/red,/turf/closed/wall/rust,/area/TDM)
"bx" = (/obj/item/banner/TDM/blue,/turf/closed/wall/rust,/area/TDM)
"by" = (/obj/effect/decal/remains/human,/turf/open/floor/sepia/TDM/dark_10,/area/TDM)
"bz" = (/turf/template_noop,/area/template_noop)
"bA" = (/obj/structure/stone_tile/surrounding_tile/cracked,/turf/open/floor/plating/asteroid,/area/TDM)
"bB" = (/obj/structure/stone_tile/center/cracked,/turf/open/floor/plating/asteroid,/area/TDM)
"bC" = (/obj/structure/stone_tile,/turf/open/floor/plating/asteroid,/area/TDM)
"bD" = (/obj/structure/stone_tile/surrounding_tile/cracked{dir = 8},/turf/open/floor/plating/asteroid,/area/TDM)
"bE" = (/obj/structure/stone_tile/surrounding_tile/cracked{dir = 6},/turf/open/floor/plating/asteroid,/area/TDM)
"bF" = (/obj/structure/stone_tile/surrounding,/obj/structure/stone_tile/center/cracked,/turf/open/floor/plating/asteroid,/area/TDM)
"bG" = (/obj/item/clothing/head/crown{resistance_flags = 115},/obj/structure/stone_tile/slab/cracked,/turf/open/floor/plating/asteroid,/area/TDM)
"bH" = (/obj/structure/stone_tile/block/cracked{dir = 4},/turf/open/floor/plating/asteroid,/area/TDM)
"bI" = (/obj/structure/stone_tile/center/cracked,/obj/structure/stone_tile/surrounding_tile/cracked{dir = 4},/turf/open/floor/plating/asteroid,/area/TDM)
"bJ" = (/obj/structure/stone_tile/block/cracked{dir = 8},/obj/structure/stone_tile/surrounding_tile/cracked{dir = 6},/turf/open/floor/plating/asteroid,/area/TDM)
"bK" = (/obj/structure/stone_tile,/obj/structure/stone_tile/surrounding_tile/cracked{dir = 8},/turf/open/floor/plating/asteroid,/area/TDM)
"bL" = (/obj/structure/stone_tile/surrounding_tile/cracked{dir = 4},/turf/open/floor/plating/asteroid,/area/TDM)
"bM" = (/obj/machinery/gateway{dir = 8},/obj/machinery/gateway{dir = 9; layer = 4.1; pixel_y = 32},/turf/open/floor/sepia/TDM/dark_10,/area/TDM)
"bN" = (/obj/TDM_map_modifier/Dust1,/turf/closed/wall/rust,/area/TDM)
"bO" = (/obj/machinery/gateway/centerstation{density = 0; layer = 3.1; level = 2},/obj/effect/portal/permanent{icon_state = "portal"; id = "dust1_p_1"; name = "portal"; pixel_y = 9},/obj/machinery/gateway{density = 0; dir = 1; layer = 4.1; pixel_y = 32},/turf/open/floor/sepia/TDM/dark_10,/area/TDM)
"bP" = (/obj/machinery/gateway{dir = 4},/obj/machinery/gateway{dir = 5; layer = 4.1; pixel_y = 32},/turf/open/floor/sepia/TDM/dark_10,/area/TDM)
"bQ" = (/obj/machinery/gateway,/turf/open/floor/sepia/TDM/dark_10,/area/TDM)
"bR" = (/obj/machinery/status_display{font_color = "#F00"; message1 = "RED"; message2 = "BASE"},/turf/closed/indestructible/riveted/TDM/wall,/area/TDM/red_base)
"bS" = (/obj/machinery/status_display{message1 = "BLUE"; message2 = "BASE"},/turf/closed/indestructible/riveted/TDM/wall,/area/TDM/blue_base)
"bT" = (/obj/machinery/status_display{font_color = "#F00"; message1 = "KILLS"},/turf/closed/indestructible/riveted/TDM/wall,/area/TDM/red_base)
"bU" = (/obj/machinery/status_display{message1 = "KILLS"},/turf/closed/indestructible/riveted/TDM/wall,/area/TDM/blue_base)
"bV" = (/obj/structure/displaycase/TDM_item_spawn/grenade_launcher,/turf/open/indestructible,/area/TDM/red_base)
"bW" = (/obj/structure/displaycase/TDM_item_spawn/grenade_launcher,/turf/open/indestructible,/area/TDM/blue_base)
"bX" = (/obj/structure/displaycase/TDM_item_spawn/rocket_launcher,/turf/open/indestructible,/area/TDM/red_base)
"bY" = (/obj/structure/displaycase/TDM_item_spawn/rocket_launcher,/turf/open/indestructible,/area/TDM/blue_base)
"bZ" = (/obj/structure/displaycase/TDM_item_spawn/frag_grenade,/turf/open/indestructible,/area/TDM/red_base)
"ca" = (/obj/structure/displaycase/TDM_item_spawn/frag_grenade,/turf/open/indestructible,/area/TDM/blue_base)
"cb" = (/obj/structure/displaycase/TDM_item_spawn/rcd,/turf/open/indestructible,/area/TDM/red_base)
"cc" = (/obj/structure/displaycase/TDM_item_spawn/rcd,/turf/open/indestructible,/area/TDM/blue_base)
"cd" = (/obj/structure/ore_box/TDM,/turf/open/floor/sepia/TDM/dark_10,/area/TDM)
"ce" = (/obj/machinery/power/port_gen/pacman{anchored = 1; resistance_flags = 115},/turf/open/floor/sepia/TDM/dark_10,/area/TDM)
"cf" = (/obj/structure/displaycase/TDM_item_spawn/medigun,/turf/open/indestructible,/area/TDM/red_base)
"cg" = (/obj/structure/displaycase/TDM_item_spawn/medigun,/turf/open/indestructible,/area/TDM/blue_base)
"ch" = (/obj/structure/TDM_dresser,/turf/open/indestructible,/area/TDM/red_base)
"ci" = (/obj/structure/TDM_dresser,/turf/open/indestructible,/area/TDM/blue_base)

(1,1,1) = {"
aaaaaaaaaaaaaaaaaaaaaaaaaaaaaaaaaaaaaaaaaaaaaaaaaaaaaaaaaaaaaaaaaaaaaaaaaaaaaaaaaaaaaaaaaaaaaaaaaaaaaaaaaaaaaaaaaaaaaaaaaaaaaaaaaaaaaaaaaaaaaaaaaaaaaaaaaaaaaaaaaaaaaaaaaaaaaaaaaaaaaaaaaaaaaaaaaa
aaabababababababababababababababababababababababababababababababababababababababababababababababababababababababababababababababababababababababababababababababababababababababababababababababaa
aaababababababababababababacacacacacacacacacabababacacacacacacacadacacacacabaeacacacacacacacacabababacacacacacacacacaeabacacacacadacacacacacacacabababacacacacacacacacacababababababababababababaa
aaabababababababababababacacacacacacacacacacabaeacacacacacacacacacacacacacabacacacacacadadacabafagahabacadadacacacacacabacacacacacacacacacacacacacaeabacacacacacacacacacacabababababababababababaa
aaabababababacacacacacacacacadacacacacacacacacacacacacadadadacacacacacacacacacacaiaiacacacacabajakalabacacacacaiaiacacacacacacacacacacadadadacacacacacacacacacacacacadacacacacacacacacabababababaa
aaababababacacacacacacacacacadacacacacacacacacacacacacacadadacacacacacabacacacacacaiaiacacacacacamacacacacacaiaiacacacacacabacacacacacadadacacacacacacacacacacacacacadacacacacacacacacacababababaa
aaabababacacacacababaeacacacacacacacabacacacacabacacacacacacacacacacacabacacacacacacaiacacacacacacacacacacacaiacacacacacacabacacacacacacacacacacacabacacacacabacacacacacacacaeababacacacacabababaa
aaababacacacacababababacacacacacacababacacacacacacacacacacacacadadacacacacacabacacacacacaeacacacacacacacaeacacacacacabacacacacacadadacacacacacacacacacacacacababacacacacacacababababacacacacababaa
aaababacacacababababababananababababababababacacacacababababababababanabababababababacacacacaiaiaiaiaiacacacacacababababababanababababababababacacacacababababababababananababababababacacacababaa
aaababananababababababaoaoaoaoabapaoaoaoaoabacacacacadabaoaoaoaoabaoaoaoaoabababacacacacacacacacacacacacacacacacacabababaoaoaoaoabaoaoaoaoabadacacacacabaoaoaoaoapabaoaoaoaoababababababananababaa
aaababaoaoaoaoapaqaqaoaoaoaoaoaqaoaoaoaoaoaracacacacacasaoaoaoaoaoaoaoaoaoaoabacacacacacacacacacacacacacacacacacacacabaoaoaoaoaoaoaoaoaoaoatacacacacacaraoaoaoaoaoaqaoaoaoaoaoaqaqapaoaoaoaoababaa
aaabaoaoaoaoaoaoaoaoaoaoaoaoaoaoaoaoabaoaoabacacacacacabaoaoabaoaoaoauaoaoaoabacacacacacacacacacacacacacacacacacacacabaoaoaoauaoaoaoabaoaoabacacacacacabaoaoabaoaoaoaoaoaoaoaoaoaoaoaoaoaoaoaoabaa
aaabaoaoaoaoaoaoaoaoaoaoaqaoaoaoaoaoabaoaoatacacadadacabaoaoaoaoaoauauaoaoaoatacacacacacabababacacacabababacacacacacasaoaoaoauauaoaoaoaoaoabacadadacacasaoaoabaoaoaoaoaoaqaoaoaoaoaoaoaoaoaoaoabaa
aaavavawavaxavavavayaoaoaoaqaoaqaqaoabaoaoabaeacacacacababaoaoaoauauaoaoaoaoatacacabacacacacabanananabacacacacabacacasaoaoaoaoauauaoaoaoababacacacacaeabaoaoabaoaqaqaoaqaoaoaoazaAaAaAaBaAaCaAaAaa
aaavaDaEaEaEaEaEaDavavaoaoaoaoaoaqaoabaoaoababarararababaoaoaoauauaoaoaoaoaoatacababacacacacabaoaoaoabacacacacababacasaoaoaoaoaoauauaoaoaoababarararababaoaoabaoaqaoaoaoaoaoaAaAaFaGaGaGaGaGaFaAaa
aaavaEaEaEaEaEaEaEaDavaoaoaoaoaoaoaoabaoaoaoaoaoaoaoaoaoaoaoaoaoaoaoaoaoaoaoababababababananabaoaoaoabananababababababaoaoaoaoaoaoaoaoaoaoaoaoaoaoaoaoaoaoaoabaoaoaoaoaoaoaoaAaFaGaGaGaGaGaGaGaAaa
aaavaEaEaEaEaEaEaEaEavaoaoaoaoaoaoaoabaoaoaoaoaoaoaoaoaoaHaoaoaoaoaoaoaoaoaoaoaoaoababaoaoaoaoaoaoaoaoaoaoaoababaoaoaoaoaoaoaoaoaoaoaoaoaHaoaoaoaoaoaoaoaoaoabaoaoaoaoaoaoaoaAaGaGaGaGaGaGaGaGaAaa
aaavchaEaEaIavaEaEaEaxaoaoabaoaoaoababababababaoaoaoaoaoaHaHaoaoaoaoaqaoaoaoaoaoaoabaoaoaoaoaoaoaoaoaoaoaoaoaoabaoaoaoaoaoaoaqaoaoaoaoaHaHaoaoaoaoaoababababababaoaoaoabaoaoaBaGaGaGaAaJaGaGciaAaa
aaavaKaEaEaLavaEaEaEaxaoaoabaoaoaoaoaoaoaoaoaoaoaoaoaoaoaoaHaHaoaoaqaoaoaoaoabaoaoabaoaoaoaoaqaoaoaoaqaoaoaoaoabaoaoabaoaoaoaoaqaoaoaHaHaoaoaoaoaoaoaoaoaoaoaoaoaoaoaoabaoaoaBaGaGaGaAaMaGaGaNaAaa
aaayaOaEaEaPayaEaEaEavaoaoaoaoaoaoaoaoaoaoaoaoaoaoaoaoaoaoaoaoaoaoaoaoaoaoapabaoaoaoaoaoaoaoaqabababaqaoaoaoaoaoaoaoabaoaoaoaoaoaoaoaoaoaoaoaoaoaoaoaoaoaoaoaoaoaoaoaoaoaoaoaAaGaGaGazaQaGaGaRazaa
aaavaSaEaEaTavbVaEaEavaoaoaoaoaoaoaoaoaoaHaoaoaHaHaHaHaoaoaoaHaUaUaoaoaoaoababaoaoaoaoaoaoaoaoabababaoaoaoaoaoaoaoaoababaoaoaoaoaUaUaHaoaoaoaHaHaHaHaoaoaHaoaoaoaoaoaoaoaoaoaAaGaGbWaAaVaGaGaWaAaa
aaavaDaEaEaXbRbZaEaEawaoaoaoaoaoaoaoaoaHaHaoaoaoaoaoaHaHaoaoaUaUaUaUaYaYaoaoaoaoaoabaoaoaoaoaoapbdapaoaoaoaoaoabaoaoaoaoaoaYaYaUaUaUaUaoaoaHaHaoaoaoaoaoaHaHaoaoaoaoaoaoaoaoaCaGaGcabSaZaGaGaFaAaa
aaavbaaEaEcfavaEaEaEawaoaoaoaoaoaHaHaHaHaHaoaoaoaoaoaoaHaoaoaUaUaUaUaYaYaUaoaoaoaoabababaoaoaoaoaoaoaoaoaoabababaoaoaoaoaUaYaYaUaUaUaUaoaoaHaoaoaoaoaoaoaHaHaHaHaHaoaoaoaoaoaCaGaGaGaAcgaGaGbbaAaa
aaavaDaEaEaXbTbXaEaEawaoaoaoaoaoapaHaHaHaoaoaoaoaoaoaoaoaoaobcaUaUaUaYaYaUaoabaoaoaoaoabaoaoaoaoaobBaoaoaoabaoaoaoaoabaoaUaYaYaUaUaUbcaoaoaoaoaoaoaoaoaoaoaHaHaHapaoaoaoaoaoaCaGaGbYbUaZaGaGaFaAaa
aaavbeaEaEbfavcbaEaEavaoaoaoaoaoaoaoaHaoaoaoaoaoaoaoaoaoaoaoaobcaUaUaYaYaUaUabaoaoaoaoaoaoaoboaoaoaoaoaoaoaoaoaoaoaoabaUaUaYaYaUaUbcaoaoaoaoaoaoaoaoaoaoaoaoaHaoaoaoaoaoaoaoaAaGaGccaAbgaGaGbhaAaa
aaaybiaEaEbjayaEaEaEavaoaoabaoaoaoaoaoaoaoaoaoaoaoaqaqaoaoaoaoaobcaUaYaYaUaUaUaoaoaoaoaoaoaoaoaobrbEbDaoaoaoaoaoaoaoaUaUaUaYaYaUbcaoaoaoaoaoaqaqaoaoaoaoaoaoaoaoaoaoaoabaoaoaAaGaGaGazbkaGaGblazaa
aaavbmaEaEbnavaEaEaEaxaoaoabaoaoaoaoaoaoaqaqaoaoaoaqapaoaoaoaoaoaoaoaoaoaoaUabaoaoaoaoaoaoaobJbFbGbFaobCaoaoaoaoaoaoabaUaoaoaoaoaoaoaoaoaoaoapaqaoaoaoaqaqaoaoaoaoaoaoabaoaoaBaGaGaGaAbpaGaGbqaAaa
aaavaEaEaEaIavaEaEaEaxaoaoabaoaoaHaHaoaoaoaqaoaoaoaoaoaoaoaoaoaoaoaoaoaoaoaoabaoaoaoaoabaoaobKaobobAaoaoaoabaoaoaoaoabaoaoaoaoaoaoaoaoaoaoaoaoaoaoaoaoaqaoaoaoaHaHaoaoabaoaoaBaGaGaGaAaJaGaGaGaAaa
aaavaEaEaEaEaEaEaEaEavaoaoaoaoaoaoaHaHaoaoaoaoaoaoaoaoaoaoaHaHbcaHaHaoaoaoaoaoaoaoaoaoabaoaobLbHaobIbAaoaoabaoaoaoaoaoaoaoaoaoaHaHbcaHaHaoaoaoaoaoaoaoaoaoaoaHaHaoaoaoaoaoaoaAaGaGaGaGaGaGaGaGaAaa
aaavaEaEaEaEaEaEaEaDavaoaoaoaqaoaoaoaHaHaoaoaoaoaoaoaoaoaoaoaoaoaHaHaHaoaoaoaoaoaoaoaoabaoaoaoaobEaoaoaoaoabaoaoaoaoaoaoaoaoaHaHaHaoaoaoaoaoaoaoaoaoaoaoaoaHaHaoaoaoaqaoaoaoaAaFaGaGaGaGaGaGaGaAaa
aaavaDaEaEaEaEaEaDavayaoaoaoaoaoaoaoaoaoaoaoaHaHaoaoaoaoaoaoaqaoaoaHaoaoaoaoabapaoaoabababaoaoaoaoaoaoaoabababaoaoapabaoaoaoaoaHaoaoaqaoaoaoaoaoaoaHaHaoaoaoaoaoaoaoaoaoaoaoazaAaFaGaGaGaGaGaFaAaa
aaavavawavaxavavavavaoaoaoaoaoaoaoaoaoaoaoaoaoaHaHaoaoaoaoaoaoaqaoaHaoaoaoababababanabababababanananabababababanababababaoaoaoaHaoaqaoaoaoaoaoaoaHaHaoaoaoaoaoaoaoaoaoaoaoaoaoaAaAaAaAaBaAaCaAaAaa
aaabaoaoaoaoaoaoaoaqaoaoababbsbsbsababaoaoaoaoaoaHaHaoaoaoaoaoaoaoaHaoaoabababbtbtbtbtbtabbubtbtbtbtbtbuabbtbtbtbtbtabababaoaoaHaoaoaoaoaoaoaoaHaHaoaoaoaoaoababbsbsbsababaoaoaqaoaoaoaoaoaoaoabaa
aaabaoaoaoaoaoaoaoaqaoaoabbtbtbtbtbtabaoaoaoaoaoaoaoaoaoabaoaoaoaoaoaoaoaoaoabbtbtbtbtbtbtbtbtbtbtbtbtbtbtbtbtbtbtbtabaoaoaoaoaoaoaoaoaoabaoaoaoaoaoaoaoaoaoabbtbtbtbtbtabaoaoaqaoaoaoaoaoaoaoabaa
aaabaoaoaoaoaqaoaoaoaoaobsbtbtbtbtbtbsaoaoaoaoaoaoaoaoaoabaoaoaoaoaoaoaoaoaoabbtbtababbtbtbtbtbtbtbtbtbtbtbtababbtbtabaoaoaoaoaoaoaoaoaoabaoaoaoaoaoaoaoaoaobsbtbtbtbtbtbsaoaoaoaoaoaqaoaoaoaoabaa
aaabaoaoaqaqabaoaoaoaoaoabbtbtbtbtbuabapaoaoaoaoaoaoaoabababababababababanababbtbtbtababbtbtbtbtbtbtbtbtbtababbtbtbtababanabababababababababaoaoaoaoaoaoaoapabbubtbtbtbtabaoaoaoaoaoabaqaqaoaoabaa
aaabaoaoaqabapaoaoababababbtbtbtababababababananababababbubtbtbtbtbtbtbtbtabbtbtbtbtbtbtbtbtbtbtbtbtbtbtbtbtbtbtbtbtbtabbtbtbtbtbtbtbtbtbuababababananababababababbtbtbtababababaoaoapabaqaoaoabaa
aaabaoaoaqaqaoaoaoabbvbtbtbtbtbtbtbtbtbtbvbvbtbtbtbtbuabbtbtbtbtbtbtbtbtbtabbtbtabbtbtbtbtbtbtbtbtbtbtbtbtbtbtbtabbtbtabbtbtbtbtbtbtbtbtbtabbubtbtbtbtbvbvbtbtbtbtbtbtbtbtbtbvabaoaoaoaqaqaoaoabaa
aaabaoaoaqaqaoaoaoabbtbtbtbtbtbtbtbtbtbtbtbtbtbtbtbtbtabbtbtbvbvbvbtbtabababbtbtbtbtbtbtbtbtabababababbtbtbtbtbtbtbtbtabababbtbtbvbvbvbtbtabbtbtbtbtbtbtbtbtbtbtbtbtbtbtbtbtbtabaoaoaoaqaqaoaoabaa
aaabaoaoaobwaoaoaoasbtbtbtbtbtbtabbtbtbtbtbtbtbtbtbtbtbtbtbtbtbvbvbtbtbtbtbvbtbtbtbtababbtbtabbtbtbtabbtbtababbtbtbtbtbtbtbtbtbtbvbvbtbtbtbtbtbtbtbtbtbtbtbtbtbtabbtbtbtbtbtbtataoaoaobxaoaoaoabaa
aaabaoaoaoaoaoaoaoasbtbtbtbtbtbtabbvbtbtbtbtbtbtbtbtbtbtbtbtbtabbtbtbtbtbtbtbtbtbtababbtbtbtbtbtbtbtbtbtbtbtababbtbtbtbtbtbtbtbtbtabbtbtbtbtbtbtbtbtbtbtbtbtbtbvabbtbtbtbtbtbtataoaoaoaoaoaoaoabaa
aaababaoaoaoaqaoaoabbtbtbtbtbtbuabbvbvbtbtbtbtbtbtbtbtabbtbtbtbtbtbtbtbtbtbtbtbtababbtbtabbtbtbtbtbtbtbtabbtbtababbtbtbtbtbtbtbtbtbtbtbtbtabbtbtbtbtbtbtbtbtbvbvabbubtbtbtbtbtabaoaoaqaoaoaoababaa
aabNababababababababababababababababababababababababababababababababababbtbtabababbybtbtabbtbtbtbtbtbtbtabbtbtbyabababbtbtabababababababababababababababababababababababababababababababababababaa
aaaaaaaaaaaaaaaaaaaaaaaaaaaaaaaaaaaaaaaaaaaaaaaaaaaaaaaaaaaaaaaaaaaaaaabbtbtbtabbtbtbtbtbtbtabbMbObPabbtbtbtbtbtbtabbtbtbtabaaaaaaaaaaaaaaaaaaaaaaaaaaaaaaaaaaaaaaaaaaaaaaaaaaaaaaaaaaaaaaaaaaaaaa
bzbzbzbzbzbzbzbzbzbzbzbzbzbzbzbzbzbzbzbzbzbzbzbzbzbzbzbzbzbzbzbzbzbzaaababbtbtbtbtbtabbtbtababcdbQceababbtbtabbtbtbtbtbtababaabzbzbzbzbzbzbzbzbzbzbzbzbzbzbzbzbzbzbzbzbzbzbzbzbzbzbzbzbzbzbzbzbzbz
bzbzbzbzbzbzbzbzbzbzbzbzbzbzbzbzbzbzbzbzbzbzbzbzbzbzbzbzbzbzbzbzbzbzaaaaabababababababababababababababababababababababababaaaabzbzbzbzbzbzbzbzbzbzbzbzbzbzbzbzbzbzbzbzbzbzbzbzbzbzbzbzbzbzbzbzbzbz
bzbzbzbzbzbzbzbzbzbzbzbzbzbzbzbzbzbzbzbzbzbzbzbzbzbzbzbzbzbzbzbzbzbzbzaaaaaaaaaaaaaaaaaaaaaaaaaaaaaaaaaaaaaaaaaaaaaaaaaaaaaabzbzbzbzbzbzbzbzbzbzbzbzbzbzbzbzbzbzbzbzbzbzbzbzbzbzbzbzbzbzbzbzbzbzbz
"}
