"a" = (/turf/closed/indestructible/riveted/TDM,/area/TDM/lobby)
"b" = (/obj/item/banner/TDM/red,/turf/open/floor/carpet/red,/area/TDM/lobby/red)
"c" = (/turf/open/floor/carpet/red,/area/TDM/lobby/red)
"d" = (/obj/item/banner/TDM/blue,/turf/open/floor/carpet/blue,/area/TDM/lobby/blue)
"e" = (/obj/structure/railing{dir = 9},/obj/structure/flora/junglebush/large,/turf/open/floor/holofloor/grass,/area/TDM/lobby)
"f" = (/turf/open/floor/carpet/blue,/area/TDM/lobby/blue)
"g" = (/obj/effect/turf_decal/stripes/line{dir = 1},/turf/open/indestructible,/area/TDM/lobby)
"h" = (/obj/structure/railing{dir = 1; resistance_flags = 115},/turf/open/floor/holofloor/grass,/area/TDM/lobby)
"i" = (/turf/open/indestructible,/area/TDM/lobby)
"j" = (/obj/structure/displaycase/TDM_item_spawn{start_showpiece_type = /obj/item/kitchen/knife/combat/TDM},/turf/open/indestructible,/area/TDM/lobby)
"k" = (/obj/structure/displaycase/TDM_item_spawn{death_count_unlock = 0; start_showpiece_type = /obj/item/gun/ballistic/automatic/pistol/TDM},/turf/open/indestructible,/area/TDM/lobby)
"l" = (/obj/structure/displaycase/TDM_item_spawn{death_count_unlock = 0; start_showpiece_type = /obj/item/gun/ballistic/automatic/pistol/m1911},/turf/open/indestructible,/area/TDM/lobby)
"m" = (/obj/structure/displaycase/TDM_item_spawn{death_count_unlock = 0; start_showpiece_type = /obj/item/gun/ballistic/automatic/pistol/deagle/TDM; tier_level = 4},/turf/open/indestructible,/area/TDM/lobby)
"n" = (/obj/structure/displaycase/TDM_item_spawn{death_count_unlock = 0; start_showpiece_type = /obj/item/gun/ballistic/automatic/sniper_rifle; tier_level = 4},/turf/open/indestructible,/area/TDM/lobby)
"o" = (/obj/structure/displaycase/TDM_item_spawn{death_count_unlock = 0; start_showpiece_type = /obj/item/gun/ballistic/automatic/c20r/unrestricted; tier_level = 4},/turf/open/indestructible,/area/TDM/lobby)
"p" = (/obj/structure/displaycase/TDM_item_spawn{ammunition = /obj/item/ammo_box/a357/TDM; death_count_unlock = 0; start_showpiece_type = /obj/item/gun/ballistic/revolver/TDM; tier_level = 2},/turf/open/indestructible,/area/TDM/lobby)
"q" = (/obj/structure/displaycase/TDM_item_spawn{ammunition = /obj/item/ammo_box/s12g; death_count_unlock = 0; start_showpiece_type = /obj/item/gun/ballistic/shotgun/TDM/buckshot; tier_level = 2},/turf/open/indestructible,/area/TDM/lobby)
"r" = (/turf/template_noop,/area/space)
"s" = (/obj/structure/displaycase/TDM_item_spawn{death_count_unlock = 0; start_showpiece_type = /obj/item/gun/ballistic/automatic/pistol/APS/TDM; tier_level = 2},/turf/open/indestructible,/area/TDM/lobby)
"t" = (/obj/structure/displaycase/TDM_item_spawn{death_count_unlock = 0; start_showpiece_type = /obj/item/gun/ballistic/automatic/surplus/TDM; tier_level = 3},/turf/open/indestructible,/area/TDM/lobby)
"u" = (/obj/structure/displaycase/TDM_item_spawn{ammunition = /obj/item/ammo_box/a762; death_count_unlock = 0; start_showpiece_type = /obj/item/gun/ballistic/rifle/boltaction; tier_level = 3},/turf/open/indestructible,/area/TDM/lobby)
"v" = (/obj/structure/displaycase/TDM_item_spawn{death_count_unlock = 0; start_showpiece_type = /obj/item/gun/ballistic/automatic/pistol/APS/TDM/uzi; tier_level = 3},/turf/open/indestructible,/area/TDM/lobby)
"w" = (/obj/structure/displaycase/TDM_item_spawn{start_showpiece_type = /obj/item/clothing/suit/armor/vest/alt; tier_level = 3},/turf/open/indestructible,/area/TDM/lobby)
"x" = (/obj/structure/displaycase/TDM_item_spawn{death_count_unlock = 0; start_showpiece_type = /obj/item/shield/riot; tier_level = 3},/turf/open/indestructible,/area/TDM/lobby)
"y" = (/obj/structure/displaycase/TDM_item_spawn{start_showpiece_type = /obj/item/clothing/head/helmet/sec; tier_level = 4},/turf/open/indestructible,/area/TDM/lobby)
"z" = (/obj/structure/railing{dir = 5},/obj/structure/flora/junglebush/large,/turf/open/floor/holofloor/grass,/area/TDM/lobby)
"A" = (/turf/closed/indestructible/fakedoor{name = "Lobby Door"},/area/TDM/lobby)
"B" = (/obj/structure/TDM/wallmed,/turf/closed/indestructible/riveted/TDM,/area/TDM/lobby)
"C" = (/obj/effect/turf_decal/plaque,/turf/open/indestructible,/area/TDM/lobby)
"D" = (/obj/effect/turf_decal/loading_area{dir = 1},/turf/open/indestructible,/area/TDM/lobby)
"E" = (/obj/structure/railing{dir = 8},/turf/open/floor/holofloor/grass,/area/TDM/lobby)
"F" = (/obj/structure/flora/tree/jungle/small,/turf/open/floor/holofloor/grass,/area/TDM/lobby)
"G" = (/obj/structure/railing{dir = 4},/turf/open/floor/holofloor/grass,/area/TDM/lobby)
"H" = (/obj/structure/flora/junglebush/b,/turf/open/floor/holofloor/grass,/area/TDM/lobby)
"I" = (/mob/living/simple_animal/pet/penguin/emperor/shamebrero/guin{icon = 'icons/oldschool/simple_animals.dmi'; icon_dead = "guin"; icon_living = "guin"; icon_state = "guin"},/turf/open/floor/holofloor/grass,/area/TDM/lobby)
"J" = (/obj/structure/railing{dir = 4},/obj/structure/flora/junglebush/large,/turf/open/floor/holofloor/grass,/area/TDM/lobby)
"K" = (/obj/structure/railing{dir = 8},/obj/structure/flora/junglebush/large,/turf/open/floor/holofloor/grass,/area/TDM/lobby)
"L" = (/turf/open/floor/holofloor/grass,/area/TDM/lobby)
"M" = (/obj/structure/railing{dir = 10; resistance_flags = 115},/turf/open/floor/holofloor/grass,/area/TDM/lobby)
"N" = (/obj/machinery/door/window{name = "Guin pen"},/turf/open/floor/holofloor/grass,/area/TDM/lobby)
"O" = (/obj/structure/railing{dir = 6; resistance_flags = 115},/turf/open/floor/holofloor/grass,/area/TDM/lobby)
"P" = (/obj/effect/turf_decal/stripes/corner{dir = 1},/turf/open/indestructible,/area/TDM/lobby)
"Q" = (/obj/effect/turf_decal/stripes/corner{dir = 4},/mob/living/simple_animal/hostile/retaliate/goat/pineapple,/turf/open/indestructible,/area/TDM/lobby)
"R" = (/obj/machinery/status_display{message1 = "RED"; message2 = "TEAM"; resistance_flags = 115},/turf/closed/indestructible/riveted/TDM,/area/TDM/lobby)
"S" = (/obj/machinery/status_display{message1 = "BLUE"; message2 = "TEAM"; resistance_flags = 115},/turf/closed/indestructible/riveted/TDM,/area/TDM/lobby)

(1,1,1) = {"
aaaRaRaaaaaaaSaSaaa
abcccccbehzdfffffda
acccccccEFGfffffffa
acccccccEHGfffffffa
acccccccEIJfffffffa
acccccccKLGfffffffa
abcccccbMNOdfffffda
agggggggPiQggggggga
AiiDiDiiiiiiiDiDiiA
aiiiiiiiiCiiiiiiiia
aBjkliiiiiiiiimnoBa
aaaaapqsiiituvaaaaa
rrrraaaawxyaaaarrrr
rrrrrrraaaaarrrrrrr
"}
