"aa" = (/turf/closed/indestructible/riveted/TDM,/area/TDM)
"ab" = (/turf/closed/wall/rust,/area/TDM)
"ac" = (/turf/open/floor/sepia/TDM,/area/TDM)
"ad" = (/obj/structure/ore_box/TDM,/turf/open/floor/sepia/TDM,/area/TDM)
"ae" = (/obj/structure/TDM/floodlight,/turf/open/floor/plating/asteroid/basalt,/area/TDM)
"af" = (/obj/machinery/door/poddoor/shutters{id = "-noid"; name = "pod bay"; resistance_flags = "LAVA_PROOF, FIRE_PROOF, UNACIDABLE, ACID_PROOF, INDESTRUCTIBLE"},/turf/open/floor/engine,/area/TDM)
"ag" = (/obj/effect/turf_decal/stripes/asteroid/line{dir = 9},/obj/structure/ore_box/TDM{color = "#e6e6e6"},/turf/open/floor/engine,/area/TDM)
"ah" = (/obj/effect/turf_decal/stripes/asteroid/line{dir = 1},/turf/open/floor/engine,/area/TDM)
"ai" = (/turf/open/floor/engine,/area/TDM)
"aj" = (/obj/structure/marker_beacon{mouse_opacity = 0; picked_color = "Bronze"; pixel_x = -5; pixel_y = 4; resistance_flags = "LAVA_PROOF, FIRE_PROOF, UNACIDABLE, ACID_PROOF, INDESTRUCTIBLE"},/turf/open/floor/engine,/area/TDM)
"ak" = (/obj/effect/turf_decal/stripes/asteroid/line{dir = 8},/turf/open/floor/engine,/area/TDM)
"al" = (/obj/effect/turf_decal/stripes/asteroid/line{dir = 4},/turf/open/floor/engine,/area/TDM)
"am" = (/obj/structure/marker_beacon{mouse_opacity = 0; picked_color = "Bronze"; pixel_x = 5; pixel_y = 4; resistance_flags = "LAVA_PROOF, FIRE_PROOF, UNACIDABLE, ACID_PROOF, INDESTRUCTIBLE"},/turf/open/floor/engine,/area/TDM)
"an" = (/turf/open/floor/plasteel/stairs/TDM/sepia/up,/area/TDM)
"ao" = (/turf/open/floor/plating/asteroid/basalt,/area/TDM)
"ap" = (/obj/structure/TDM/floodlight,/turf/open/floor/sepia/TDM,/area/TDM)
"aq" = (/obj/structure/lattice/catwalk,/obj/structure/railing{dir = 4},/obj/structure/railing{dir = 8},/turf/open/lava/smooth{slowdown = 0.5},/area/TDM)
"ar" = (/obj/structure/window/plastitanium/tough/TDM,/obj/structure/grille,/turf/open/floor/sepia/TDM,/area/TDM)
"as" = (/turf/open/floor/plasteel/stairs/TDM/sepia/left,/area/TDM)
"at" = (/turf/open/floor/plasteel/stairs/TDM/sepia/right,/area/TDM)
"au" = (/obj/structure/lattice/catwalk,/obj/structure/railing,/obj/structure/railing{dir = 1},/turf/open/lava/smooth{slowdown = 0.5},/area/TDM)
"av" = (/turf/closed/indestructible/riveted/TDM/wall,/area/TDM/red_base)
"aw" = (/obj/machinery/door/poddoor{id = "redpod"; resistance_flags = 115},/obj/effect/turf_decal/stripes/asteroid/line{dir = 10},/turf/open/floor/engine,/area/TDM)
"ax" = (/obj/machinery/door/poddoor{id = "bluepod"; resistance_flags = 115},/obj/effect/turf_decal/stripes/asteroid/line{dir = 6},/turf/open/floor/engine,/area/TDM)
"ay" = (/obj/item/banner/TDM/red,/turf/closed/indestructible/riveted/TDM/wall,/area/TDM/red_base)
"az" = (/obj/item/banner/TDM/blue,/turf/closed/indestructible/riveted/TDM/wall,/area/TDM/blue_base)
"aA" = (/turf/closed/indestructible/riveted/TDM/wall,/area/TDM/blue_base)
"aB" = (/obj/structure/mineral_door/iron/TDM,/obj/structure/TDM/spawn_protection/red,/obj/structure/fans/tiny/invisible,/turf/open/floor/plating/rust,/area/TDM/red_base)
"aC" = (/turf/open/floor/plasteel/stairs/TDM/sepia/right{dir = 8},/area/TDM)
"aD" = (/obj/structure/TDM/floodlight,/turf/open/indestructible,/area/TDM/red_base)
"aE" = (/turf/open/indestructible,/area/TDM/red_base)
"aF" = (/obj/structure/TDM/floodlight,/turf/open/indestructible,/area/TDM/blue_base)
"aG" = (/turf/open/indestructible,/area/TDM/blue_base)
"aH" = (/turf/closed/mineral/volcanic,/area/TDM)
"aI" = (/obj/structure/TDM/medical_cabinet{pixel_x = 9},/obj/structure/TDM/wallmed{pixel_x = -6},/turf/closed/indestructible/riveted/TDM/wall,/area/TDM/red_base)
"aJ" = (/obj/structure/TDM/medical_cabinet{pixel_x = -9},/obj/structure/TDM/wallmed{pixel_x = 6},/turf/closed/indestructible/riveted/TDM/wall,/area/TDM/blue_base)
"aK" = (/obj/structure/displaycase/TDM_item_spawn/revolver,/turf/open/indestructible,/area/TDM/red_base)
"aL" = (/obj/structure/displaycase/TDM_item_spawn/knife,/turf/open/indestructible,/area/TDM/red_base)
"aM" = (/obj/structure/displaycase/TDM_item_spawn/shotgun,/turf/open/indestructible,/area/TDM/red_base)
"aN" = (/obj/structure/mineral_door/iron/TDM,/obj/structure/TDM/spawn_protection/blue,/obj/structure/fans/tiny/invisible,/turf/open/floor/sepia/TDM,/area/TDM/blue_base)
"aO" = (/obj/structure/displaycase/TDM_item_spawn/knife,/turf/open/indestructible,/area/TDM/blue_base)
"aP" = (/obj/structure/displaycase/TDM_item_spawn/revolver,/turf/open/indestructible,/area/TDM/blue_base)
"aQ" = (/obj/structure/displaycase/TDM_item_spawn/stechkin,/turf/open/indestructible,/area/TDM/red_base)
"aR" = (/obj/structure/displaycase/TDM_item_spawn/APS,/turf/open/indestructible,/area/TDM/red_base)
"aS" = (/obj/structure/displaycase/TDM_item_spawn/stechkin,/turf/open/indestructible,/area/TDM/blue_base)
"aT" = (/obj/structure/displaycase/TDM_item_spawn/shotgun,/turf/open/indestructible,/area/TDM/blue_base)
"aU" = (/obj/structure/ore_box/TDM{color = "#e6e6e6"},/turf/open/floor/plating/asteroid/basalt,/area/TDM)
"aV" = (/obj/structure/displaycase/TDM_item_spawn/m1911,/turf/open/indestructible,/area/TDM/red_base)
"aW" = (/obj/machinery/clonepod/TDM/team_red{TDM_on = 1},/turf/open/indestructible,/area/TDM/red_base)
"aX" = (/obj/structure/displaycase/TDM_item_spawn/m1911,/turf/open/indestructible,/area/TDM/blue_base)
"aY" = (/obj/structure/lattice/catwalk,/obj/structure/railing{dir = 6},/obj/structure/railing/corner{dir = 1},/turf/open/lava/smooth{slowdown = 0.5},/area/TDM)
"aZ" = (/obj/structure/lattice/catwalk,/obj/structure/railing{dir = 10},/obj/structure/railing/corner{dir = 4},/turf/open/lava/smooth{slowdown = 0.5},/area/TDM)
"ba" = (/obj/machinery/clonepod/TDM/team_blue{TDM_on = 1},/turf/open/indestructible,/area/TDM/blue_base)
"bb" = (/obj/structure/displaycase/TDM_item_spawn/APS,/turf/open/indestructible,/area/TDM/blue_base)
"bc" = (/obj/structure/displaycase/TDM_item_spawn/shield,/turf/open/indestructible,/area/TDM/red_base)
"bd" = (/obj/structure/lattice/catwalk,/turf/open/lava/smooth{slowdown = 0},/area/TDM)
"be" = (/obj/structure/barricade/sandbags/TDM,/turf/open/floor/plating/asteroid/basalt,/area/TDM)
"bf" = (/obj/structure/displaycase/TDM_item_spawn/carbine,/turf/open/indestructible,/area/TDM/red_base)
"bg" = (/obj/structure/displaycase/TDM_item_spawn/deagle,/turf/open/indestructible,/area/TDM/red_base)
"bh" = (/obj/structure/railing{dir = 4},/turf/open/floor/sepia/TDM,/area/TDM)
"bi" = (/obj/structure/displaycase/TDM_item_spawn/shield,/turf/open/indestructible,/area/TDM/blue_base)
"bj" = (/obj/structure/displaycase/TDM_item_spawn/bolt_action,/turf/open/indestructible,/area/TDM/red_base)
"bk" = (/obj/structure/displaycase/TDM_item_spawn/sniper,/turf/open/indestructible,/area/TDM/red_base)
"bl" = (/obj/structure/displaycase/TDM_item_spawn/deagle,/turf/open/indestructible,/area/TDM/blue_base)
"bm" = (/obj/structure/lattice/catwalk,/obj/structure/ore_box/TDM{color = "#e6e6e6"},/turf/open/lava/smooth{slowdown = 0},/area/TDM)
"bn" = (/obj/structure/railing{dir = 8},/turf/open/floor/sepia/TDM,/area/TDM)
"bo" = (/obj/structure/railing{dir = 6},/turf/open/floor/sepia/TDM,/area/TDM)
"bp" = (/obj/structure/displaycase/TDM_item_spawn/carbine,/turf/open/indestructible,/area/TDM/blue_base)
"bq" = (/obj/structure/displaycase/TDM_item_spawn/uzi,/turf/open/indestructible,/area/TDM/red_base)
"br" = (/obj/structure/displaycase/TDM_item_spawn/c20r,/turf/open/indestructible,/area/TDM/red_base)
"bs" = (/obj/structure/displaycase/TDM_item_spawn/sniper,/turf/open/indestructible,/area/TDM/blue_base)
"bt" = (/obj/structure/railing{dir = 10},/turf/open/floor/sepia/TDM,/area/TDM)
"bu" = (/obj/structure/displaycase/TDM_item_spawn/bolt_action,/turf/open/indestructible,/area/TDM/blue_base)
"bv" = (/obj/structure/lattice/catwalk,/obj/structure/ore_box/TDM{color = "#e6e6e6"},/obj/structure/railing,/turf/open/lava/smooth{slowdown = 0},/area/TDM)
"bw" = (/obj/structure/lattice/catwalk,/obj/structure/railing/corner{dir = 8},/turf/open/lava/smooth{slowdown = 0},/area/TDM)
"bx" = (/obj/machinery/status_display{font_color = "#F00"; message1 = "RED"; message2 = "BASE"},/turf/closed/indestructible/riveted/TDM/wall,/area/TDM/red_base)
"by" = (/obj/machinery/status_display{message1 = "BLUE"; message2 = "BASE"},/turf/closed/indestructible/riveted/TDM/wall,/area/TDM/blue_base)
"bz" = (/obj/structure/lattice/catwalk,/obj/structure/railing/corner,/turf/open/lava/smooth{slowdown = 0},/area/TDM)
"bA" = (/obj/structure/lattice/catwalk,/obj/structure/railing,/turf/open/lava/smooth{slowdown = 0},/area/TDM)
"bB" = (/obj/structure/railing/corner,/turf/open/floor/plating/asteroid/basalt,/area/TDM)
"bC" = (/obj/structure/railing,/turf/open/floor/plating/asteroid/basalt,/area/TDM)
"bD" = (/obj/structure/lattice/catwalk,/obj/structure/railing{dir = 8},/turf/open/lava/smooth{slowdown = 0},/area/TDM)
"bE" = (/obj/structure/barricade/wooden,/turf/open/floor/plating/asteroid/basalt,/area/TDM)
"bF" = (/obj/structure/lattice/catwalk,/obj/structure/railing{dir = 4},/turf/open/lava/smooth{slowdown = 0},/area/TDM)
"bG" = (/obj/structure/marker_beacon{mouse_opacity = 0; picked_color = "Bronze"; pixel_x = 6; pixel_y = 0; resistance_flags = "LAVA_PROOF, FIRE_PROOF, UNACIDABLE, ACID_PROOF, INDESTRUCTIBLE"},/turf/open/floor/engine,/area/TDM)
"bH" = (/obj/structure/railing{dir = 1; resistance_flags = 115},/turf/open/lava/smooth,/area/TDM)
"bI" = (/obj/item/banner/TDM/red,/turf/closed/wall/rust,/area/TDM)
"bJ" = (/obj/structure/railing/corner{resistance_flags = 115},/obj/structure/railing/corner{dir = 8},/obj/effect/turf_decal/stripes/asteroid/full,/turf/open/floor/sepia/TDM,/area/TDM)
"bK" = (/obj/structure/lattice/catwalk,/obj/structure/railing{dir = 9},/turf/open/lava/smooth{slowdown = 0},/area/TDM)
"bL" = (/turf/template_noop,/area/template_noop)
"bM" = (/obj/structure/lattice/catwalk,/obj/structure/railing/corner{dir = 1},/turf/open/lava/smooth{slowdown = 0},/area/TDM)
"bN" = (/obj/structure/lattice/catwalk,/obj/structure/railing/corner{dir = 4},/turf/open/lava/smooth{slowdown = 0},/area/TDM)
"bO" = (/obj/structure/lattice/catwalk,/obj/structure/railing{dir = 5},/turf/open/lava/smooth{slowdown = 0},/area/TDM)
"bP" = (/obj/structure/window/plastitanium/tough/TDM,/obj/structure/grille,/turf/open/floor/plating/rust,/area/TDM/red_base)
"bQ" = (/obj/structure/lattice/catwalk,/obj/structure/railing{dir = 10},/turf/open/lava/smooth{slowdown = 0},/area/TDM)
"bR" = (/turf/open/floor/plating/rust,/area/TDM)
"bS" = (/obj/structure/marker_beacon{mouse_opacity = 0; picked_color = "Bronze"; pixel_x = -6; pixel_y = 0; resistance_flags = "LAVA_PROOF, FIRE_PROOF, UNACIDABLE, ACID_PROOF, INDESTRUCTIBLE"},/turf/open/floor/engine,/area/TDM)
"bT" = (/obj/structure/TDM/floodlight,/turf/open/floor/plating/rust,/area/TDM)
"bU" = (/obj/structure/window/plastitanium/tough/TDM,/obj/structure/grille,/turf/open/floor/plating/rust,/area/TDM)
"bV" = (/obj/structure/ore_box/TDM{color = "#e6e6e6"},/turf/open/floor/plating/rust,/area/TDM)
"bW" = (/obj/structure/railing{dir = 4},/turf/open/floor/plating/asteroid/basalt,/area/TDM)
"bX" = (/obj/structure/railing/corner{dir = 4},/turf/open/floor/plating/asteroid/basalt,/area/TDM)
"bY" = (/obj/structure/railing{dir = 1},/turf/open/floor/plating/asteroid/basalt,/area/TDM)
"bZ" = (/obj/structure/railing/corner{dir = 1},/turf/open/floor/plating/asteroid/basalt,/area/TDM)
"ca" = (/obj/structure/lattice/catwalk,/obj/structure/railing{dir = 6},/turf/open/lava/smooth{slowdown = 0},/area/TDM)
"cb" = (/obj/structure/railing/corner{resistance_flags = 115},/turf/open/lava/smooth,/area/TDM)
"cc" = (/obj/structure/railing{resistance_flags = 115},/turf/open/lava/smooth,/area/TDM)
"cd" = (/obj/structure/railing/corner{dir = 8; resistance_flags = 115},/turf/open/lava/smooth,/area/TDM)
"ce" = (/obj/structure/railing{dir = 9},/turf/open/floor/plating/asteroid/basalt,/area/TDM)
"cf" = (/obj/structure/railing{dir = 5},/turf/open/floor/plating/asteroid/basalt,/area/TDM)
"cg" = (/obj/structure/railing{dir = 6; resistance_flags = 115},/turf/open/lava/smooth,/area/TDM)
"ch" = (/obj/structure/lattice/catwalk,/obj/structure/railing{dir = 1},/turf/open/lava/smooth{slowdown = 0},/area/TDM)
"ci" = (/obj/structure/closet/crate/miningcar/minecart{anchored = 1; resistance_flags = 115},/turf/open/floor/plating/asteroid/basalt,/area/TDM)
"cj" = (/obj/structure/displaycase/TDM_item_spawn/c20r,/turf/open/indestructible,/area/TDM/blue_base)
"ck" = (/obj/structure/railing/corner{dir = 8},/turf/open/floor/plating/asteroid/basalt,/area/TDM)
"cl" = (/turf/open/lava/smooth,/area/TDM)
"cm" = (/obj/structure/railing{dir = 10},/turf/open/floor/plating/asteroid/basalt,/area/TDM)
"cn" = (/obj/structure/railing{dir = 8},/turf/open/floor/plating/asteroid/basalt,/area/TDM)
"co" = (/obj/structure/railing/corner,/turf/open/floor/plating/rust,/area/TDM)
"cp" = (/obj/structure/ore_box/TDM{color = "#e6e6e6"},/obj/structure/railing,/turf/open/floor/plating/rust,/area/TDM)
"cq" = (/obj/structure/railing/corner{dir = 8},/turf/open/floor/plating/rust,/area/TDM)
"cr" = (/obj/structure/railing{dir = 4},/turf/open/floor/plating/rust,/area/TDM)
"cs" = (/obj/structure/railing{dir = 8},/turf/open/floor/plating/rust,/area/TDM)
"ct" = (/obj/structure/railing/corner{dir = 4},/turf/open/floor/plating/rust,/area/TDM)
"cu" = (/obj/structure/railing{dir = 1},/turf/open/floor/plating/rust,/area/TDM)
"cv" = (/obj/structure/railing/corner{dir = 1},/turf/open/floor/plating/rust,/area/TDM)
"cw" = (/obj/effect/turf_decal/stripes/asteroid/line{dir = 5},/obj/structure/ore_box/TDM{color = "#e6e6e6"},/turf/open/floor/engine,/area/TDM)
"cx" = (/obj/effect/turf_decal/delivery,/turf/open/floor/plating/rust,/area/TDM)
"cy" = (/obj/structure/ore_box/TDM{color = "#e6e6e6"},/obj/structure/railing,/turf/open/floor/plating/asteroid/basalt,/area/TDM)
"cz" = (/obj/structure/closet/crate{anchored = 1; resistance_flags = 115},/turf/open/floor/plating/rust,/area/TDM)
"cA" = (/obj/effect/turf_decal/loading_area{dir = 4},/turf/open/floor/plating/rust,/area/TDM)
"cB" = (/obj/effect/turf_decal/loading_area,/turf/open/floor/plating/rust,/area/TDM)
"cC" = (/obj/effect/turf_decal/stripes/asteroid/line{dir = 8},/obj/structure/ore_box/TDM{color = "#e6e6e6"},/turf/open/floor/engine,/area/TDM)
"cD" = (/obj/effect/turf_decal/stripes/asteroid/corner{dir = 1},/turf/open/floor/engine,/area/TDM)
"cE" = (/obj/pod/large/industrial{dir = 1},/turf/open/floor/engine,/area/TDM)
"cF" = (/obj/effect/turf_decal/stripes/asteroid/corner{dir = 4},/turf/open/floor/engine,/area/TDM)
"cG" = (/obj/effect/turf_decal/stripes/asteroid/line{dir = 4},/obj/structure/ore_box/TDM{color = "#e6e6e6"},/turf/open/floor/engine,/area/TDM)
"cH" = (/obj/machinery/button/door{id = "redpod"; name = "Blastdoor Control"; pixel_x = 25; pixel_y = -5; req_access_txt = "0"; resistance_flags = 115},/turf/open/floor/sepia/TDM,/area/TDM)
"cI" = (/obj/effect/turf_decal/stripes/asteroid/corner{dir = 8},/turf/open/floor/engine,/area/TDM)
"cJ" = (/obj/effect/turf_decal/stripes/asteroid/corner,/turf/open/floor/engine,/area/TDM)
"cK" = (/obj/structure/marker_beacon{mouse_opacity = 0; picked_color = "Bronze"; pixel_x = -2; resistance_flags = "LAVA_PROOF, FIRE_PROOF, UNACIDABLE, ACID_PROOF, INDESTRUCTIBLE"},/turf/open/floor/engine,/area/TDM)
"cL" = (/obj/effect/turf_decal/stripes/asteroid/line{dir = 10},/turf/open/floor/engine,/area/TDM)
"cM" = (/obj/effect/turf_decal/stripes/asteroid/line,/turf/open/floor/engine,/area/TDM)
"cN" = (/obj/structure/marker_beacon{mouse_opacity = 0; picked_color = "Bronze"; pixel_x = 2; resistance_flags = "LAVA_PROOF, FIRE_PROOF, UNACIDABLE, ACID_PROOF, INDESTRUCTIBLE"},/turf/open/floor/engine,/area/TDM)
"cO" = (/obj/effect/turf_decal/stripes/asteroid/line{dir = 6},/turf/open/floor/engine,/area/TDM)
"cP" = (/obj/effect/turf_decal/stripes/asteroid/line,/obj/structure/ore_box/TDM{color = "#e6e6e6"},/turf/open/floor/engine,/area/TDM)
"cQ" = (/obj/structure/ore_box/TDM{color = "#e6e6e6"},/turf/open/floor/sepia/TDM,/area/TDM)
"cR" = (/obj/machinery/mineral/mint{resistance_flags = 115},/turf/open/floor/plating/rust,/area/TDM)
"cS" = (/obj/machinery/door/poddoor{id = "redfactory"; resistance_flags = 115},/turf/open/floor/plating/rust,/area/TDM)
"cT" = (/obj/item/pickaxe,/turf/open/floor/plating/asteroid/basalt,/area/TDM)
"cU" = (/obj/structure/TDM/floodlight,/obj/effect/turf_decal/bot,/turf/open/floor/plating/rust,/area/TDM)
"cV" = (/obj/machinery/button/door{id = "bluepod"; name = "Blastdoor Control"; pixel_x = -25; pixel_y = -5; req_access_txt = "0"; resistance_flags = 115},/turf/open/floor/sepia/TDM,/area/TDM)
"cW" = (/obj/effect/turf_decal/stripes/asteroid/line{dir = 9},/obj/machinery/door/poddoor{id = "redpod"; resistance_flags = 115},/turf/open/floor/engine,/area/TDM)
"cX" = (/obj/effect/turf_decal/stripes/asteroid/line{dir = 5},/obj/machinery/door/poddoor{id = "bluepod"; resistance_flags = 115},/turf/open/floor/engine,/area/TDM)
"cY" = (/obj/structure/railing/corner{dir = 4},/obj/structure/railing/corner,/obj/effect/turf_decal/stripes/asteroid/full,/turf/open/floor/sepia/TDM,/area/TDM)
"cZ" = (/obj/machinery/button/door{id = "bluefactory"; name = "Blastdoor Control"; pixel_x = -25; pixel_y = 5; req_access_txt = "0"; resistance_flags = 115},/turf/open/floor/plating/rust,/area/TDM)
"da" = (/obj/item/banner/TDM/blue,/turf/closed/indestructible/riveted/TDM/wall,/area/TDM)
"db" = (/obj/TDM_map_modifier/smeltery,/turf/closed/indestructible/riveted/TDM,/area/TDM)
"dc" = (/obj/effect/turf_decal/stripes/asteroid/line,/obj/structure/marker_beacon{mouse_opacity = 0; picked_color = "Bronze"; pixel_y = 3; resistance_flags = "LAVA_PROOF, FIRE_PROOF, UNACIDABLE, ACID_PROOF, INDESTRUCTIBLE"},/turf/open/floor/engine,/area/TDM)
"dd" = (/obj/effect/turf_decal/loading_area,/obj/item/coin/gold,/turf/open/floor/plating/rust,/area/TDM)
"de" = (/obj/machinery/mineral/unloading_machine{dir = 1; icon_state = "unloader-corner"; input_dir = 1; output_dir = 2; resistance_flags = 115},/obj/effect/turf_decal/stripes/line{dir = 9},/obj/effect/turf_decal/stripes/line{dir = 5},/turf/open/floor/plating,/area/TDM)
"df" = (/obj/structure/railing{dir = 1; resistance_flags = 115},/turf/open/floor/plating/asteroid/basalt,/area/TDM)
"dg" = (/obj/machinery/conveyor{id = "mining_internal"; resistance_flags = 115},/obj/effect/turf_decal/stripes/line{dir = 8},/obj/effect/turf_decal/stripes/line{dir = 4},/turf/open/floor/plating,/area/TDM)
"dh" = (/obj/machinery/mineral/processing_unit{dir = 1; resistance_flags = 115},/obj/effect/turf_decal/stripes/line{dir = 9},/obj/effect/turf_decal/stripes/line{dir = 4},/turf/open/floor/plating,/area/TDM)
"di" = (/obj/structure/window/plastitanium/tough/TDM,/obj/structure/grille,/turf/open/floor/plating/rust,/area/TDM/blue_base)
"dj" = (/obj/structure/railing/corner{dir = 1; resistance_flags = 115},/turf/open/floor/plating/asteroid/basalt,/area/TDM)
"dk" = (/obj/structure/railing{dir = 10; resistance_flags = 115},/turf/open/lava/smooth,/area/TDM)
"dl" = (/obj/structure/railing{dir = 6; resistance_flags = 115},/turf/open/floor/plating/asteroid/basalt,/area/TDM)
"dm" = (/turf/open/floor/plasteel/stairs/TDM/sepia/left{dir = 4},/area/TDM)
"dn" = (/obj/structure/railing/corner{dir = 1},/obj/structure/railing/corner{dir = 8; resistance_flags = 115},/obj/effect/turf_decal/stripes/asteroid/full,/turf/open/floor/sepia/TDM,/area/TDM)
"do" = (/obj/machinery/door/poddoor{id = "bluefactory"; resistance_flags = 115},/turf/open/floor/plating/rust,/area/TDM)
"dp" = (/obj/machinery/button/door{id = "redfactory"; name = "Blastdoor Control"; pixel_x = 25; pixel_y = 5; req_access_txt = "0"; resistance_flags = 115},/turf/open/floor/plating/rust,/area/TDM)
"dq" = (/obj/structure/displaycase/TDM_item_spawn/uzi,/turf/open/indestructible,/area/TDM/blue_base)
"dr" = (/obj/machinery/status_display{font_color = "#F00"; message1 = "KILLS"},/turf/closed/indestructible/riveted/TDM/wall,/area/TDM/red_base)
"ds" = (/obj/machinery/status_display{message1 = "KILLS"},/turf/closed/indestructible/riveted/TDM/wall,/area/TDM/blue_base)
"dt" = (/obj/item/clothing/head/crown{resistance_flags = 115},/turf/open/floor/plating/asteroid/basalt,/area/TDM)
"du" = (/obj/TDM_map_modifier/smeltery,/turf/closed/mineral/volcanic,/area/TDM)
"dv" = (/obj/structure/TDM_dresser,/turf/open/indestructible,/area/TDM/red_base)
"dw" = (/obj/structure/TDM_dresser,/turf/open/indestructible,/area/TDM/blue_base)
"dx" = (/obj/structure/extinguisher_cabinet/regenerating{pixel_x = 0; pixel_y = -32},/turf/open/indestructible,/area/TDM/red_base)
"dy" = (/obj/structure/extinguisher_cabinet/regenerating{pixel_y = -32},/turf/open/indestructible,/area/TDM/blue_base)
"dz" = (/obj/structure/extinguisher_cabinet/regenerating{pixel_y = 32},/turf/open/indestructible,/area/TDM/red_base)
"dA" = (/obj/structure/extinguisher_cabinet/regenerating{pixel_y = 32},/turf/open/indestructible,/area/TDM/blue_base)

(1,1,1) = {"
aaaaaaaaaaaaaaaaaaaaaaaaaaaaaaaaaaaaaaaaaaaaaaaaaaaaaaaaaaaaaaaaaaaaaaaaaaaaaaaaaaaaaaaaaaaaaaaaaaaaaaaaaaaaaaaaaaaaaaaaaaaaaaaaaaaaaaaaaaaaaaaaaaaaaaaaaaaaaaaaaaaaaaaaaaaaaaaaaaaaaaaaaaaaaaaaaa
aaabababababaHaHaHaHaHaHaHaHaHaHaHabababababababababababababababababababababababababafafafafafafafafafafafafafabababababababababababababababababababababababababaHaHaHaHaHaHaHaHaHaHaHabababababaa
aaabababaHaHaHaHaHaHaHaHaHaoaoaoaoabacadadacacacacadabacacacacacacadadacacacabagahahajaiaiaiaiaiaiaiaiaiaiaiamahahcwabacacacadadacacacacacacabadacacacacadadacabaoaoaoaoaHaHaHaHaHaHaHaHaHabababaa
aaababaHaHaHaHaHaHaHaHaHaoaoaoaoaoabacacacacacacacacacacacacacacacacadacadacabcCaiaiaiaiaiaiaiaiaiaiaiaiaiaiaiaiaicGabacadacadacacacacacacacacacacacacacacacacabaoaoaoaoaoaHaHaHaHaHaHaHaHaHababaa
aaabaHaHaHaHaoaoaoaoaoaoaoaoaUaoaoatacacacacadacacacacacacadababacacacacaccHabakaiaicKaiaiaiaiaiaiaiaiaiaiaicNaiaialabcVacacacacacababadacacacacacacadacacacacaCaoaoaUaoaoaoaoaoaoaoaoaHaHaHaHabaa
aaaHaHaHaHaoaoaoaoaoaoaoaoaoaUaoaoatacacacababababacacacadadadabacacacacacaccWcDaiaiaicEaiaiaiaiaiaiaiaicEaiaiaiaicFcXacacacacacacabadadadacacacababababacacacaCaoaoaUaoaoaoaoaoaoaoaoaoaHaHaHaHaa
aaaHaHaHaoaoaoaoaHaHaeaoaoaoaoaoaoabadacacacacacabacacacadacacabacacacacacacawcIaiaibGaiaiaicEaiaicEaiaiaiaibSaiaicJaxacacacacacacabacacadacacacabacacacacacadabaoaoaoaoaoaoaeaHaHaoaoaoaoaHaHaHaa
aaaHaHaoaoaoaoaHaHaHaHaoaoaoaoaoaoababadacacacacababacacacacacabadadacacacapabcLcMcMcIaiaiaiaiaiaiaiaiaiaiaicJcMcMcOabapacacacadadabacacacacacababacacacacadababaoaoaoaoaoaoaHaHaHaHaoaoaoaoaHaHaa
aaaHaHaoaoaoaHaHaHaHaHaHaoaoaoaoaoaeababababacacapabababababababababbJabababababababcLdccPcPcMcMcMcMcMcPcPdccOabababababababbJabababababababababapacacababababaeaoaoaoaoaoaHaHaHaHaHaHaoaoaoaHaHaa
aaaHaHaoaoaHaHaHaHaHaHaoaoaoaoaoaoaoaoaoaUabacacacacadabclclclclclclaqclclabababapacacacacacaccQcQcQacacacacacacapabababclclaqclclclclclclabadacacacacabaUaoaoaoaoaoaoaoaoaoaHaHaHaHaHaHaoaoaHaHaa
aaaHaHaoaoaoaoaeaUaUaoaoaoaoaoaUaoaoaoaoaoaracacacacaccYauauauauauauaYclclclabacacacacacacacacacacacacacacacacacacacabclclclaZauauauauauaudnacacacacacaraoaoaoaoaoaUaoaoaoaoaoaUaUaeaoaoaoaoaHaHaa
aaaHaoaoaoaoaoaoaoaoaoaoaoaoaoaoaoaoaoaoaoabacacacacacabclclclclclclclclaoaoabacacacacacacacacacacacacacacacacacacacabaoaoclclclclclclclclabacacacacacabaoaoaoaoaoaoaoaoaoaoaoaoaoaoaoaoaoaoaoaHaa
aaaHaoaoaoaoaoaoaoaoaoaoaUaoaoaoaoaoaoaoaoatacacacacacabclclclclclclclaoaoaoatacacacacacabarabacacacabarabacacacacacasaoaoaoclclclclclclclabacacacacacaCaoaoaoaoaoaoaoaoaUaoaoaoaoaoaoaoaoaoaoaHaa
aaavavbPavaBavavavayaoaoaoaUaoaoaUaUaoaoaoababacacacababclclclaoaoaoaoaoaoaoatacaccQacacacacabanananabacacacaccQacacasaoaoaoaoaoaoaoclclclababacacacababaoaoaoaUaUaoaoaUaoaoaoazaAaAaAaNaAdiaAaAaa
aaavaDaEaEaEaEaEaDavavaoaoaoaoaoaoaUaoaoaoaoabarararabclclclaUaoaoaoaoaoaoaoataccQcQacacacacbhbdbdbdbnacacacaccQcQacasaoaoaoaoaoaoaoaUclclclabarararabaoaoaoaoaUaoaoaoaoaoaoaAaAaFaGaGaGaGaGaFaAaa
aaavaEaEaEaEaEaEaEaDavaoaoaoaoaoaoaoaoaoaoaobWclclclclclaUaUaoaoaoaoaoaoaoaoabababababanananbobdbdbdbtanananabababababaoaoaoaoaoaoaoaoaUaUclclclclclcnaoaoaoaoaoaoaoaoaoaoaoaAaFaGaGaGaGaGaGaGaAaa
aaavaEaEaEaEdxaEaEaEavaoaoaoaoaoaoaoaoaoaoaobXbYbYbYbYbYbZaoaoaoaoaoaoaoaoaoaoaoclababbdbdbdbdbdbdbdbdbdbdbdababclaoaoaoaoaoaoaoaoaoaoaobXbYbYbYbYbYdjaoaoaoaoaoaoaoaoaoaoaoaAaGaGaGdyaGaGaGaGaAaa
aaavdvaEaEaIavaEaEaEaBaoaoaUaoaoaoaoaobmaoaoaoaoaoaoaoaoaoaoaoaoaoaoaUaoaoaoaoclclclabbvbwbzbAbwbdbzbAbwbzbvabclclclaoaoaoaoaUaoaoaoaoaoaoaoaoaoaoaoaoaoaobmaoaoaoaoaoaUaoaoaNaGaGaGaAaJaGaGdwaAaa
aaavaKaEaEaLavaEaEaEaBaoaoaUaoaoaoaoaobdbdaoaoaoaoaoaoaoaoaoaoaoaoaUaoaoaoaoclclclclclclbDbFclbDbdbFclbDbFclclclclclclaoaoaoaoaUaoaoaoaoaoaoaoaoaoaoaoaobdbdaoaoaoaoaoaUaoaoaNaGaGaGaAaOaGaGaPaAaa
aaayaMaEaEaQayaEaEaEavaoaoaoaoaoaoaobdbdbdbdaoaoaoaoaoaUaoaoaHaoaoaoaoaoaoclclclclclclclbDbFclbDbdbFclbDbFclclclclclclclaoaoaoaoaoaoaHaoaoaUaoaoaoaoaobdbdbdbdaoaoaoaoaoaoaoaAaGaGaGazaSaGaGaTazaa
aaavaRaEaEaVavaEaEaEavcybCbCbCbCabbHbHbHbHbHbHabclclclaHbEbEaHclclclclclclclclclclclclbKbMbFclbDbmbFclbDbNbOclclclclclclclclclclclclaHbEbEaHclclclabbHbHbHbHbHbHabbCbCbCbCcyaAaGaGaGaAaXaGaGbbaAaa
aaavaDaEaEaWbxaEaEaEbPclclclclclclclclclclclclclclaHaHaHaoaoaHaHaoclclclclclclclclclbKbMbdbFclbDbdbFclbDbdbNbOclclclclclclclclclaoaHaHaoaoaHaHaHclclclclclclclclclclclclclcldiaGaGaGbybaaGaGaFaAaa
aaavbcaEaEaEavaEaEaEbPclclclclclclclclclclclclclaHaHaHaoaoaoaoaHbebeclclclclclclclclbDbdbdbFclbDbdbFclbDbdbdbFclclclclclclclclbebeaHaoaoaoaoaHaHaHclclclclclclclclclclclclcldiaGaGaGaAaGaGaGbiaAaa
aaavaDaEaEaWdraEaEaEbPclclclclclclclclclclclclaHaHcTaoaoaoaoaoaoaobeclclclclclclclclbDbmbdbFclbDbdbFclbDbdbmbFclclclclclclclclbeaoaoaoaoaoaoaocTaHaHclclclclclclclclclclclcldiaGaGaGdsbaaGaGaFaAaa
aaavbfaEaEbgavaEaEaEavclcebYbYcfclclclclclclclaHaHaoaoaoaUaUaoaoaoaHaoclclclclclclclbQbwbdbFclbDbdbFclbDbdbzcaclclclclclclclaoaHaoaoaoaUaUaoaoaoaHaHclclclclclclclcebYbYcfclaAaGaGaGaAblaGaGbpaAaa
aaaybjaEaEbkayaEaEaEavbYbZaoaobXabclclclclclclaHaHaHaoaoaociaUaoaoaHaHclclclclclclclclbQbwbFclbDbmbFclbDbzcaclclclclclclclclaHaHaoaoaUciaoaoaoaHaHaHclclclclclclabdjaoaobXbYaAaGaGaGazbsaGaGbuazaa
aaavbqaEaEbravaEaEaEaBaoaoaUaoaoaoaUclclclclclclaHaHaHaoaoaoaoaoaHaHaHclclclclclclclclclbDbFclbDbdbFclbDbFclclclclclclclclclaHaHaHaoaoaoaoaoaHaHaHclclclclclclaUaoaoaoaUaoaoaNaGaGaGaAcjaGaGdqaAaa
aaavaEaEaEaIavaEaEaEaBaoaoaUaoaoaoaoaoclclclclclclclaHaHaoaoaoaHaHaHclclcbcccccccccdclclbDbFclbDbdbFclbDbFclclcbcccccccccdclclaHaHaHaoaoaoaHaHclclclclclclclaoaoaoaoaoaUaoaoaNaGaGaGaAaJaGaGaGaAaa
aaavaEaEaEaEdzaEaEaEavaoaoaoaoaoaUaoaoaoaoaoclclclclclaHbEbEaHaHaHaoclcbcgbdbdbdbdabababbMbNchbMbdbNchbMbNabababbdbdbdbddkcdclaoaHaHaHbEbEaHclclclclclaoaoaoaoaoaUaoaoaoaoaoaAaGaGaGdAaGaGaGaGaAaa
aaavaEaEaEaEaEaEaEaDavaoaoaoaoaoaUaoaoaoaoaoaoaoaoaoaoaUaoaoaHaHaoaoaoaUbdbdbdbdbRbRbRbRbdbdbdbdbdbdbdbdbdbRbRbRbRbdbdbdbdaUaoaoaoaHaHaoaoaUaoaoaoaoaoaoaoaoaoaoaUaoaoaoaoaoaAaFaGaGaGaGaGaGaGaAaa
aaavaDaEaEaEaEaEaDavayaoaoaoaoaoaoaoaoaoaoaoaoaoaoaoaoaoaoaoaUaoaoaoaoaoaobdabbTbRbRabababbdbdbdbdbdbdbdabababbRbRbTabbdaoaoaoaoaoaoaUaoaoaoaoaoaoaoaoaoaoaoaoaoaoaoaoaoaoaoazaAaFaGaGaGaGaGaFaAaa
aaavavbPavaBavavavavaoaoaoaoaoaoaoaoaoaoaoaoaUaUaoaoaoaoaoaoaoaoaoaoaoaoabababababanabababababanananabababababanabababababaoaoaoaoaoaoaoaoaoaoaoaoaUaUaoaoaoaoaoaoaoaoaoaoaoaoaAaAaAaAaNaAdiaAaAaa
aaaHaoaoaoaoaoaoaoaUaoaoaoabbUbUbUabaoaoaoaoaoaoaoaoaoaobBbCbCbCckaoaoababbVabcUbRbRbRbRabcUbRcBcBcBbRcUabbRbRbRbRcUabbVababaoaobBbCbCbCckaoaoaoaoaoaoaoaoaoaoabbUbUbUabaoaoaoaUaoaoaoaoaoaoaoaHaa
aaaHaoaoaoaoaoaoaoaUaoaoababbRbRbRababaoaoaoaoaoaoaoaoaoabclclclcmbCababbRbRabbRbRbRbRbRbRbRbRbRbRbRbRbRbRbRbRbRbRbRabbRbRababbCdlclclclabaoaoaoaoaoaoaoaoaoababbRbRbRababaoaoaUaoaoaoaoaoaoaoaHaa
aaaHaobBbCcycyckaoaoaoaobUbRbRbRbRbRbUaoaoaoaoaoaoaoaoaoabclclclclclabbRbRbRabbRbRbVbVbRbRbRbRbRbRbRbRbRbRbRbVbVbRbRabbRbRbRabclclclclclabaoaoaoaoaoaoaoaoaobUbRbRbRbRbRbUaoaoaoaobBcycybCckaoaHaa
aaaHaobWclclclcnaoaoaoaoabbRczcAcRbRabaeaoaoaoaoaoaoaoabababbUbUbUababbRbRbRbRbRbRbRbVbVbRbRcocpcpcpcqbRbRbVbVbRbRbRbRbRbRbRababbUbUbUabababaoaoaoaoaoaoaoaeabbRcRcAczbRabaoaoaoaobWclclclcnaoaHaa
aaaHaobWclclcebZaoababababbRbRbRddbRababababananababababbTbRbRbRbRbRbRbRbRbRbRbRbRcBbRbRcBbRcrclclclcsbRcBbRbRcBbRbRbRbRbRbRbRbRbRbRbRbRbTababababananababababbRddbRbRbRababababaobXcfclclcnaoaHaa
aaaHaobWclclcnaoaoabbVbRbRbRbRbRbRbRbRbRbVbVbRbRbRbRbTabbRbRbRbRbRbRbRbRbRabbRbRbRcxbRbRcxbRcrcldtclcsbRcxbRbRcxbRbRbRabbRbRbRbRbRbRbRbRbRabbTbRbRbRbRbVbVbRbRbRbRbRbRbRbRbRbVabaoaobWclclcnaoaHaa
aaaHaobWclclcnaoaoabbRbRbRbRbRbRbRbRbRbRbRbVbRbRbRbRbRcSbRbRbVbVbVbRbRbRababbRbRbRdebRbRdebRcrclclclcsbRdebRbRdebRbRbRababbRbRbRbVbVbVbRbRdobRbRbRbRbRbVbRbRbRbRbRbRbRbRbRbRbRabaoaobWclclcnaoaHaa
aaaHaobXdfbIbZaoaoasbRbRbRbRbRbRabbRbRbRbRbRbRbRbRbRbRcSbRbRbRbVbVbRbRbRbRbVbRbRbRdgbRbRdgbRcrclclclcsbRdgbRbRdgbRbRbRbVbRbRbRbRbVbVbRbRbRdobRbRbRbRbRbRbRbRbRbRabbRbRbRbRbRbRdmaoaobXdadfdjaoaHaa
aaaHaoaoaoaoaoaoaoasbRbRbRbRbRbRabbVbRbRbRbRbRbRbVbRdpabbRbRbRbRbRbRbRbRbRbRbRbRbRdhbRbRdhbRcrclclclcsbRdhbRbRdhbRbRbRbRbRbRbRbRbRbRbRbRbRabcZbRbVbRbRbRbRbRbRbVabbRbRbRbRbRbRdmaoaoaoaoaoaoaoaHaa
aaaHaHaoaoaoaUaoaeabbRbRbRbRbRbTabbVbVbRbVbRbRbRbRbRbRbUbRbRbRbRbRbRbRbRbRbRbRbRabdgbRbRdgbRctcucucucvbRdgbRbRdgabbRbRbRbRbRbRbRbRbRbRbRbRbUbRbRbRbRbRbRbVbRbVbVabbTbRbRbRbRbRabaeaoaUaoaoaoaHaHaa
aaduaHaHaHaHaHaHaHabababababababababababababababababababababababababababbRbRbRbVbVcBbRbRcBbRbRbRbRbRbRbRcBbRbRcBbVbVbRbRbRabababababababababababababababababababababababababababaHaHaHaHaHaHaHabaa
dbaaaaaaaaaaaaaaaaaaaaaaaaaaaaaaaaaaaaaaaaaaaaaaaaaaaaaaaaaaaaaaaaaaaaabcUbRbRbRbRbRbRbRbRbRbRbVbVbVbRbRbRbRbRbRbRbRbRbRcUabaaaaaaaaaaaaaaaaaaaaaaaaaaaaaaaaaaaaaaaaaaaaaaaaaaaaaaaaaaaaaaaaaaaaaa
bLbLbLbLbLbLbLbLbLbLbLbLbLbLbLbLbLbLbLbLbLbLbLbLbLbLbLbLbLbLbLbLbLbLaaababbRbRbRbRbRcUbRbRbRbVbVbVbVbVbRbRbRcUbRbRbRbRbRababaabLbLbLbLbLbLbLbLbLbLbLbLbLbLbLbLbLbLbLbLbLbLbLbLbLbLbLbLbLbLbLbLbLbL
bLbLbLbLbLbLbLbLbLbLbLbLbLbLbLbLbLbLbLbLbLbLbLbLbLbLbLbLbLbLbLbLbLbLaaaaabababababababababababababababababababababababababaaaabLbLbLbLbLbLbLbLbLbLbLbLbLbLbLbLbLbLbLbLbLbLbLbLbLbLbLbLbLbLbLbLbLbL
bLbLbLbLbLbLbLbLbLbLbLbLbLbLbLbLbLbLbLbLbLbLbLbLbLbLbLbLbLbLbLbLbLbLbLaaaaaaaaaaaaaaaaaaaaaaaaaaaaaaaaaaaaaaaaaaaaaaaaaaaaaabLbLbLbLbLbLbLbLbLbLbLbLbLbLbLbLbLbLbLbLbLbLbLbLbLbLbLbLbLbLbLbLbLbLbL
"}
