"a" = (/turf/closed/indestructible/riveted/TDM,/area/TDM)
"b" = (/turf/closed/wall/rust,/area/TDM)
"c" = (/turf/open/floor/holofloor/grass,/area/TDM)
"d" = (/turf/closed/indestructible/riveted/TDM/wall,/area/TDM/red_base)
"e" = (/obj/structure/window/plastitanium/tough/TDM,/obj/structure/grille,/turf/open/floor/sepia/TDM,/area/TDM/red_base)
"f" = (/obj/structure/mineral_door/iron/TDM,/obj/structure/TDM/spawn_protection/red,/obj/structure/fans/tiny/invisible,/turf/open/floor/sepia/TDM,/area/TDM/red_base)
"g" = (/obj/item/banner/TDM/red,/turf/closed/indestructible/riveted/TDM/wall,/area/TDM/red_base)
"h" = (/obj/item/banner/TDM/blue,/turf/closed/wall,/area/TDM/blue_base)
"i" = (/turf/closed/wall,/area/TDM/blue_base)
"j" = (/obj/structure/mineral_door/iron/TDM,/obj/structure/TDM/spawn_protection/blue,/obj/structure/fans/tiny/invisible,/turf/open/floor/sepia/TDM,/area/TDM/blue_base)
"k" = (/obj/structure/window/plastitanium/tough/TDM,/obj/structure/grille,/turf/open/floor/sepia/TDM,/area/TDM/blue_base)
"l" = (/obj/structure/TDM/floodlight,/turf/open/indestructible,/area/TDM/red_base)
"m" = (/turf/open/indestructible,/area/TDM/red_base)
"n" = (/obj/structure/TDM/floodlight,/turf/open/indestructible,/area/TDM/blue_base)
"o" = (/turf/open/indestructible,/area/TDM/blue_base)
"p" = (/obj/structure/TDM/medical_cabinet{pixel_x = 9},/obj/structure/TDM/wallmed{pixel_x = -6},/turf/closed/indestructible/riveted/TDM/wall,/area/TDM/red_base)
"q" = (/obj/structure/TDM/medical_cabinet{pixel_x = -9},/obj/structure/TDM/wallmed{pixel_x = 6},/turf/closed/wall,/area/TDM/blue_base)
"r" = (/obj/structure/displaycase/TDM_item_spawn/revolver,/turf/open/indestructible,/area/space)
"s" = (/turf/open/indestructible,/area/space)
"t" = (/obj/structure/displaycase/TDM_item_spawn/knife,/turf/open/indestructible,/area/space)
"u" = (/obj/structure/displaycase/TDM_item_spawn/knife,/turf/open/indestructible,/area/TDM/blue_base)
"v" = (/obj/structure/displaycase/TDM_item_spawn/revolver,/turf/open/indestructible,/area/TDM/blue_base)
"w" = (/obj/structure/displaycase/TDM_item_spawn/shotgun,/turf/open/indestructible,/area/space)
"x" = (/obj/structure/displaycase/TDM_item_spawn/stechkin,/turf/open/indestructible,/area/space)
"y" = (/obj/structure/displaycase/TDM_item_spawn/stechkin,/turf/open/indestructible,/area/TDM/blue_base)
"z" = (/obj/structure/displaycase/TDM_item_spawn/shotgun,/turf/open/indestructible,/area/TDM/blue_base)
"A" = (/obj/structure/displaycase/TDM_item_spawn/APS,/turf/open/indestructible,/area/space)
"B" = (/obj/structure/displaycase/TDM_item_spawn/m1911,/turf/open/indestructible,/area/space)
"C" = (/obj/structure/displaycase/TDM_item_spawn/m1911,/turf/open/indestructible,/area/TDM/blue_base)
"D" = (/obj/structure/displaycase/TDM_item_spawn/APS,/turf/open/indestructible,/area/TDM/blue_base)
"E" = (/obj/machinery/clonepod/TDM/team_blue{TDM_on = 1},/turf/open/indestructible,/area/TDM/blue_base)
"F" = (/obj/structure/TDM/floodlight,/turf/open/indestructible,/area/space)
"G" = (/obj/machinery/clonepod/TDM/team_red{TDM_on = 1},/turf/open/indestructible,/area/space)
"H" = (/obj/structure/displaycase/TDM_item_spawn/shield,/turf/open/indestructible,/area/space)
"I" = (/obj/structure/displaycase/TDM_item_spawn/shield,/turf/open/indestructible,/area/TDM/blue_base)
"J" = (/obj/structure/displaycase/TDM_item_spawn/carbine,/turf/open/indestructible,/area/space)
"K" = (/obj/structure/displaycase/TDM_item_spawn/deagle,/turf/open/indestructible,/area/space)
"L" = (/obj/structure/displaycase/TDM_item_spawn/deagle,/turf/open/indestructible,/area/TDM/blue_base)
"M" = (/obj/structure/displaycase/TDM_item_spawn/carbine,/turf/open/indestructible,/area/TDM/blue_base)
"N" = (/obj/structure/displaycase/TDM_item_spawn/bolt_action,/turf/open/indestructible,/area/space)
"O" = (/obj/structure/displaycase/TDM_item_spawn/sniper,/turf/open/indestructible,/area/space)
"P" = (/obj/structure/displaycase/TDM_item_spawn/sniper,/turf/open/indestructible,/area/TDM/blue_base)
"Q" = (/obj/structure/displaycase/TDM_item_spawn/bolt_action,/turf/open/indestructible,/area/TDM/blue_base)
"R" = (/obj/structure/displaycase/TDM_item_spawn/uzi,/turf/open/indestructible,/area/space)
"S" = (/obj/structure/displaycase/TDM_item_spawn/c20r,/turf/open/indestructible,/area/space)
"T" = (/turf/template_noop,/area/template_noop)
"U" = (/obj/structure/displaycase/TDM_item_spawn/c20r,/turf/open/indestructible,/area/TDM/blue_base)
"V" = (/obj/structure/displaycase/TDM_item_spawn/uzi,/turf/open/indestructible,/area/TDM/blue_base)

(1,1,1) = {"
aaaaaaaaaaaaaaaaaaaaaaaaaaaaaaaaaaaaaaaaaaaaaaaaaaaaaaaaaaaaaaaaaaaaaaaaaaaaaaaaaaaaaaaaaaaaaaaaa
abbbbbbbbbbbbbbbbbbbbbbbbbbbbbbbbbbbbbbbbbbbbbbbbbbbbbbbbbbbbbbbbbbbbbbbbbbbbbbbbbbbbbbbbbbbbbbba
abcccccccccccccccccccccccccccccccccccccccccccccccccccccccccccccccccccccccccccccccccccccccccccccba
abcccccccccccccccccccccccccccccccccccccccccccccccccccccccccccccccccccccccccccccccccccccccccccccba
abcccccccccccccccccccccccccccccccccccccccccccccccccccccccccccccccccccccccccccccccccccccccccccccba
abcccccccccccccccccccccccccccccccccccccccccccccccccccccccccccccccccccccccccccccccccccccccccccccba
abcccccccccccccccccccccccccccccccccccccccccccccccccccccccccccccccccccccccccccccccccccccccccccccba
abcccccccccccccccccccccccccccccccccccccccccccccccccccccccccccccccccccccccccccccccccccccccccccccba
abcccccccccccccccccccccccccccccccccccccccccccccccccccccccccccccccccccccccccccccccccccccccccccccba
abcccccccccccccccccccccccccccccccccccccccccccccccccccccccccccccccccccccccccccccccccccccccccccccba
abcccccccccccccccccccccccccccccccccccccccccccccccccccccccccccccccccccccccccccccccccccccccccccccba
abcccccccccccccccccccccccccccccccccccccccccccccccccccccccccccccccccccccccccccccccccccccccccccccba
abcccccccccccccccccccccccccccccccccccccccccccccccccccccccccccccccccccccccccccccccccccccccccccccba
addedfdddgccccccccccccccccccccccccccccccccccccccccccccccccccccccccccccccccccccccccccccchiiijikiia
adlmmmmmlddccccccccccccccccccccccccccccccccccccccccccccccccccccccccccccccccccccccccccciinooooonia
admmmmmmmldcccccccccccccccccccccccccccccccccccccccccccccccccccccccccccccccccccccccccccinoooooooia
admmmmmmmmdccccccccccccccccccccccccccccccccccccccccccccccccccccccccccccccccccccccccccciooooooooia
admmmpdmmmfcccccccccccccccccccccccccccccccccccccccccccccccccccccccccccccccccccccccccccjoooiqoooia
adrsstdmmmfcccccccccccccccccccccccccccccccccccccccccccccccccccccccccccccccccccccccccccjoooiuoovia
agwssxgmmmdccccccccccccccccccccccccccccccccccccccccccccccccccccccccccccccccccccccccccciooohyoozha
adAssBdmmmdcccccccccccccccccccccccccccccccccccccccccccccccccccccccccccccccccccccccccccioooiCooDia
adFssGdmmmeccccccccccccccccccccccccccccccccccccccccccccccccccccccccccccccccccccccccccckoooiEoonia
adHsssdmmmeccccccccccccccccccccccccccccccccccccccccccccccccccccccccccccccccccccccccccckoooioooIia
adFssGdmmmeccccccccccccccccccccccccccccccccccccccccccccccccccccccccccccccccccccccccccckoooiEoonia
adJssKdmmmdcccccccccccccccccccccccccccccccccccccccccccccccccccccccccccccccccccccccccccioooiLooMia
agNssOgmmmdccccccccccccccccccccccccccccccccccccccccccccccccccccccccccccccccccccccccccciooohPooQha
adRssSdmmmfcccccccccccccccccccccccccccccccccccccccccccccccccccccccccccccccccccccccccccjoooiUooVia
admmmpdmmmfcccccccccccccccccccccccccccccccccccccccccccccccccccccccccccccccccccccccccccjoooiqoooia
admmmmmmmmdccccccccccccccccccccccccccccccccccccccccccccccccccccccccccccccccccccccccccciooooooooia
admmmmmmmldcccccccccccccccccccccccccccccccccccccccccccccccccccccccccccccccccccccccccccinoooooooia
adlmmmmmldgccccccccccccccccccccccccccccccccccccccccccccccccccccccccccccccccccccccccccchinooooonia
addedfddddccccccccccccccccccccccccccccccccccccccccccccccccccccccccccccccccccccccccccccciiiijikiia
abcccccccccccccccccccccccccccccccccccccccccccccccccccccccccccccccccccccccccccccccccccccccccccccba
abcccccccccccccccccccccccccccccccccccccccccccccccccccccccccccccccccccccccccccccccccccccccccccccba
abcccccccccccccccccccccccccccccccccccccccccccccccccccccccccccccccccccccccccccccccccccccccccccccba
abcccccccccccccccccccccccccccccccccccccccccccccccccccccccccccccccccccccccccccccccccccccccccccccba
abcccccccccccccccccccccccccccccccccccccccccccccccccccccccccccccccccccccccccccccccccccccccccccccba
abcccccccccccccccccccccccccccccccccccccccccccccccccccccccccccccccccccccccccccccccccccccccccccccba
abcccccccccccccccccccccccccccccccccccccccccccccccccccccccccccccccccccccccccccccccccccccccccccccba
abcccccccccccccccccccccccccccccccccccccccccccccccccccccccccccccccccccccccccccccccccccccccccccccba
abcccccccccccccccccccccccccccccccccccccccccccccccccccccccccccccccccccccccccccccccccccccccccccccba
abbccccccccccccccccccccccccccccccccccccccccccccccccccccccccccccccccccccccccccccccccccccccccccccba
abbbbbbbbbbbbbbbbbbbbbbbbbbbbbbbbbbbcccccccccccccccccccccccccbbbbbbbbbbbbbbbbbbbbbbbbbbbbbbbbbbba
aaaaaaaaaaaaaaaaaaaaaaaaaaaaaaaaaaabcccccccccccccccccccccccccbaaaaaaaaaaaaaaaaaaaaaaaaaaaaaaaaaaa
TTTTTTTTTTTTTTTTTTTTTTTTTTTTTTTTTTabbcccccccccccccccccccccccbbaTTTTTTTTTTTTTTTTTTTTTTTTTTTTTTTTTT
TTTTTTTTTTTTTTTTTTTTTTTTTTTTTTTTTTaabbbbbbbbbbbbcbbbbbbbbbbbbaaTTTTTTTTTTTTTTTTTTTTTTTTTTTTTTTTTT
TTTTTTTTTTTTTTTTTTTTTTTTTTTTTTTTTTTaaaaaaaaaaaaaaaaaaaaaaaaaaaTTTTTTTTTTTTTTTTTTTTTTTTTTTTTTTTTTT
"}
